border_size=1
usage=map

Ww          , Ww          , Ww          , Mm          , Mm          , Mm          , Mm          , Mm          , Mm          , Mm          , Mm          , Mm          , Mm          , Mm          , Mm          , Mm          , Mm          , Mm          , Mm          , Mm          , Mm          , Mm          , Mm          , Mm          , Hh          , Gs^Fp       , Gs^Fp       , Rd          , Gs^Fp       , Gs^Fp       , Mm          , Mm          
Ww          , Ww          , Ww          , Mm          , Mm          , Mm          , Mm          , Mm          , Mm          , Mm          , Mm          , Mm          , Mm          , Mm          , Mm          , Mm          , Mm          , Mm          , Mm          , Mm          , Mm          , Mm          , Mm          , Mm          , Hh^Fp       , Gs^Fp       , Gs^Fms      , Rd          , Gg^Fet      , Gs^Fp       , Mm          , Mm          
Mm          , Mm          , Mm          , Mm          , Mm          , Mm          , Mm          , Mm          , Mm          , Mm          , Mm          , Mm          , Mm          , Mm          , Mm          , Mm          , Mm          , Mm          , Mm          , Mm          , Mm          , Mm          , Mm          , Hh          , Hh^Fp       , Gs^Fp       , Rd          , Rd          , Gs^Fp       , Hh^Fp       , Mm          , Mm          
Mm          , Mm          , Mm          , Mm          , Mm          , Mm          , Gg^Ve       , Mm          , Mm          , Mm          , Mm          , Mm          , Mm          , Mm          , Mm          , Mm          , Mm          , Mm          , Gg^Ve       , Mm          , Mm          , Mm          , Mm          , Hh          , Hh          , Gs^Fp       , Rd          , Gs^Fp       , Hh^Fp       , Hh          , Mm          , Mm          
Mm          , Mm          , Mm          , Mm          , Mm          , Mm          , Mm          , Mm          , Hh          , Mm          , Mm          , Gg^Ve       , Mm          , Mm          , Mm          , Gg          , Gg          , Gg          , Gg          , Gg          , Gg          , Gg          , Gg          , Gg          , Gg^Efm         , Gg^Efm         , Rd          , Gs^Fp       , Gg^Ve       , Hh          , Mm          , Mm          
Mm          , Mm          , Mm          , Mm          , Mm          , Mm          , Mm          , Mm          , Gg^Vh       , Hh          , Mm          , Mm          , Mm          , Mm          , Mm          , Hh          , Gg^Ve       , Hh          , Hh          , Hh          , Hh          , Hh          , Hh          , Hh          , Gg          , Gg          , Rd          , Gg          , Mm          , Mm          , Mm          , Mm          
Mm          , Mm          , Mm          , Mm          , Mm          , Mm          , Mm          , Hh          , Mm          , Hh^Fp       , Gs^Fms      , Gs^Fp       , Gg          , Gg          , Gg^Efm         , Gg          , Gg          , Gg          , Gg          , Gg          , Cv          , Cv          , Cv          , Gg          , Rd          , Rd          , Gg^Ve       , Hh          , Mm          , Mm          , Mm          , Mm          
Mm          , Mm          , Mm          , Mm          , Gg^Ve       , Mm          , Mm          , Mm          , Mm          , Ww          , Gg          , Gg          , Gg          , Gg          , Gg          , Gg^Efm         , Gg          , Gg          , Gg          , Gg          , Cv          , 1 Kv        , Cv          , Rd          , Gg          , Gg          , Hh          , Hh          , Mm          , Mm          , Mm          , Mm          
Mm          , Mm          , Mm          , Mm          , Mm          , Mm          , Mm          , Mm          , Mm          , Mm          , Mm          , Gg^Ve       , Gs^Fp       , Gs^Fp       , Gs^Fp       , Gg          , Gg          , Ww          , Ww          , Ww          , Ww          , Ww^Bw|      , Rd          , Rd          , Ss          , Ss          , Hh          , Hh          , Mm          , Mm          , Mm          , Mm          
Mm          , Mm          , Mm          , Mm          , Mm          , Mm          , Gg^Ve       , Mm          , Mm          , Mm          , Mm          , Gs^Fp       , Gg^Fet      , Gs^Fp       , Gs^Fms      , Gg          , Gg          , Ww          , Ww          , Ww          , Ww          , Ww          , Ww          , Ww          , Ww          , Ww          , Mm          , Mm          , Mm          , Mm          , Mm          , Mm          
Mm          , Mm          , Mm          , Mm          , Mm          , Mm          , Mm          , Mm          , Mm          , Mm          , Mm          , Gs^Fms      , Gs^Fp       , Gs^Fp       , Gg^Ve       , Gg          , Gg          , Ww          , Ww          , Ww          , Hh          , Hh          , Hh          , Hh          , Ww          , Ww          , Ww          , Ww          , Ww          , Ww          , Ww          , Ww          
Mm          , Mm          , Mm          , Mm          , Mm          , Mm          , Mm          , Mm          , Mm          , Mm          , Gg^Ve       , Gs^Fp       , Gs^Fms      , Gg          , Gg          , Gg          , Ww          , Ww          , Ww          , Hh          , Hh          , Mm          , Mm          , Hh^Vhh      , Mm          , Mm          , Mm          , Mm          , Mm          , Mm          , Mm          , Mm          
Mm          , Mm          , Mm          , Mm          , Mm          , Mm          , Mm          , Hh          , Hh          , Gs^Fp       , Gs^Fms      , Gs^Fp       , Gg          , Gg          , Ww          , Ww          , Ww          , Gg          , Rd          , Hh          , Hh          , Mm          , Mm          , Mm          , Mm          , Mm          , Mm          , Mm          , Mm          , Mm          , Mm          , Mm          
Mm          , Mm          , Mm          , Mm          , Mm          , Mm          , Mm          , Mm          , Mm          , Hh          , Hh          , Gs^Fp       , Gg          , Ww          , Ww          , Ww          , Gg          , Gg          , Rd          , Hh          , Mm          , Mm          , Mm          , Mm^Vhh      , Mm          , Mm          , Mm          , Mm          , Mm          , Mm          , Mm          , Mm          
Mm          , Mm          , Mm          , Mm          , Gs^Fp       , Gs^Fp       , Gs^Fp       , Gs^Fp       , Gg^Ve       , Gg          , Gg          , Ww          , Ww          , Ww          , Ww          , Ww          , Rd          , Rd          , Hh          , Mm          , Mm          , Mm          , Mm          , Mm          , Mm          , Mm          , Mm          , Mm          , Mm          , Mm          , Mm          , Mm          
Mm          , Mm          , Mm          , Mm          , Gg^Fet      , Gs^Fms      , Gs^Fp       , Ww          , Ww          , Ww          , Ww          , Ww          , Gg          , Re          , Ww          , Ww          , Rd          , Hh          , Hh          , Mm          , Mm          , Mm          , Mm          , Mm          , Mm^Vhh      , Mm          , Mm          , Mm          , Mm          , Mm          , Mm          , Mm          
Mm          , Mm          , Mm          , Mm          , Mm          , Gs^Fms      , Gg^Ve       , Ww          , Ww          , Gs^Fms      , Gg^Ve       , Gs^Fp       , Gs^Fms      , Ww          , Mm          , Hh          , Mm          , Mm          , Mm          , Mm          , Mm          , Mm          , Mm          , Mm          , Hh^Vhh      , Mm          , Mm          , Mm          , Mm          , Mm          , Mm          , Mm          
Mm          , Mm          , Mm          , Mm          , Hh          , Hh          , Ww          , Ww          , Ww          , Gs^Fp       , Gs^Fms      , Ww          , Ww          , Ww          , Mm          , Cud         , Cud         , Cud         , Cud         , Mm          , Mm          , Mm          , Mm          , Mm          , Mm          , Hh          , Hh          , Mm          , Mm          , Mm          , Mm          , Mm          
Mm          , Mm          , Hh          , Hh          , Hh          , Ww          , Ww          , Ww          , Gg^Ve       , Gs^Fp       , Ww          , Ww          , Mm          , Mm          , Mm          , Cud         , 2 Kud       , Cud         , Cud         , Mm          , Mm          , Mm          , Mm          , Mm          , Mm          , Mm          , Hh          , Hh^Fp       , Mm          , Mm          , Mm          , Mm          
Mm          , Mm          , Hh          , Hh          , Ww          , Ww          , Ww          , Re          , Gs^Fp       , Gs^Fms      , Ww          , Ww          , Mm          , Mm          , Mm          , Cud         , Cud         , Cud         , Cud         , Mm          , Mm          , Mm          , Mm          , Mm^Vhh      , Mm          , Hh          , Hh          , Hh          , Mm          , Mm          , Mm          , Mm          
Mm          , Mm          , Hh          , Hh          , Ww          , Ww          , Ww          , Gs^Fms      , Gs^Fp       , Ww          , Ww          , Mm          , Mm          , Mm          , Hh^Fp       , Hh^Fp       , Hh^Fp       , Hh^Fp       , Hh^Fp       , Hh^Fp       , Hh^Fp       , Mm          , Mm          , Mm          , Hh^Fp       , Hh          , Mm          , Mm          , Mm          , Mm          , Mm          , Mm          
Hh^Fp       , Gs^Fp       , Gs^Fms      , Ww          , Ww          , Ww          , Ww          , Ww          , Ww          , Ww          , Hh^Fp       , Hh^Fp       , Hh^Fp       , Hh^Fp       , Hh^Fp       , Hh^Fp       , Hh^Fp       , Hh^Fp       , Hh^Fp       , Hh^Fp       , Hh^Fp       , Hh^Fp       , Hh^Fp       , Mm          , Hh          , Hh          , Mm          , Mm          , Mm          , Mm          , Mm          , Mm          
Hh^Fp       , Gs^Fp       , Gg^Vc       , Ww          , Ww          , Ww          , Ww          , Gg          , Gs^Fp       , Hh^Fp       , Hh^Fp       , Mm          , Mm          , Mm          , Mm          , Mm          , Mm          , Mm          , Mm          , Mm          , Mm          , Mm          , Mm          , Hh^Vhh      , Hh          , Mm          , Mm          , Mm          , Mm          , Mm          , Mm          , Mm          
Hh^Fp       , Gs^Fp       , Gs^Fp       , Gg          , Gg          , Ww          , Ww          , Ww          , Re          , Hh          , Gs^Fp       , Hh          , Gs^Fp       , Hh          , Hh          , Mm          , Mm          , Mm          , Mm          , Mm          , Mm          , Mm          , Mm          , Mm          , Hh          , Hh          , Hh          , Mm          , Mm          , Mm          , Mm          , Mm          
Hh^Fp       , Gs^Fms      , Gs^Fms      , Gs^Fp       , Gg          , Gg          , Gg          , Ww          , Ww          , Ww          , Re          , Re          , Gs^Fp       , Gs^Fp       , Gs^Fp       , Hh          , Hh          , Hh          , Mm          , Mm          , Mm          , Gs^Fp       , Gs^Fp       , Gs^Fp       , Mm          , Mm          , Mm          , Mm          , Mm          , Mm          , Mm          , Mm          
Mm          , Mm          , Mm          , Mm          , Gg^Ve       , Mm          , Hh          , Ww          , Ww          , Ww          , Ww          , Ww          , Ww          , Gg          , Re          , Re          , Hh^Vhh      , Gg          , Hh          , Hh          , Hh          , Mm          , Mm          , Mm          , Mm          , Mm          , Mm^Vhh      , Mm          , Mm          , Mm          , Mm          , Mm          
Chr         , Chr         , Chr         , Chr         , Mm          , Mm          , Mm          , Hh          , Hh          , Gs^Fp       , Ww          , Ww          , Ww          , Ww          , Ww          , Gg          , Gg          , Hh          , Hh          , Mm          , Mm          , Mm          , Mm          , Mm          , Mm          , Mm          , Mm          , Mm          , Mm          , Mm          , Mm          , Mm          
Chr         , Khr         , Chr         , 3 Mm        , Mm          , Mm          , Mm          , Mm          , Mm          , Gs^Fp       , Gs^Fp       , Gs^Fp       , Gg          , Gg          , Ww          , Ww          , Ww          , Ww          , Ww          , Mm          , Mm          , Mm          , Mm          , Mm          , Mm          , Mm          , Mm          , Mm          , Mm          , Mm          , Mm          , Mm          
Chr         , Chr         , Chr         , Chr         , Mm          , Mm          , Mm          , Mm          , Mm          , Mm          , Mm          , Mm          , Hh          , Gg          , Ww          , Ww          , Ww          , Ww          , Ww          , Mm          , Mm          , Mm          , Mm          , Mm          , Mm          , Mm          , Hh          , Mm          , Mm          , Mm          , Mm          , Mm          
Mm          , Mm          , Mm          , Mm          , Mm          , Mm          , Mm          , Mm          , Mm          , Mm          , Mm          , Hh          , Hh          , Gs^Fp       , Rd          , Ww          , Ww          , Ww          , Ww          , Mm          , Mm          , Mm          , Mm          , Mm          , Mm          , Mm          , Mm          , Mm          , Hh^Fp       , Mm          , Mm          , Mm          
Mm          , Mm          , Mm          , Mm          , Mm          , Mm          , Mm          , Mm          , Mm          , Mm          , Mm          , Hh          , Hh          , Gs^Fp       , Rd          , Gg          , Ww          , Ww          , Ww          , Ww          , Mm          , Mm          , Mm          , Mm^Vhh      , Mm          , Mm          , Mm          , Mm          , Hh^Fp       , Mm          , Mm          , Mm          
Mm          , Mm          , Mm          , Mm          , Mm          , Mm          , Mm          , Mm          , Mm          , Mm          , Mm          , Hh          , Hh          , Gs^Fp       , Rd          , Gg^Vc       , Gs^Fp       , Hh          , Ww          , Ww          , Ww          , Ww          , Mm          , Mm          , Mm          , Mm          , Mm          , Mm          , Mm          , Mm          , Mm          , Mm          
Mm          , Mm          , Mm          , Mm          , Mm          , Mm          , Mm          , Hh^Fp       , Hh^Fp       , Hh^Fp       , Hh^Fp       , Hh^Fp       , Gs^Fp       , Gg^Efm         , Rd          , Gs^Fp       , Hh          , Hh          , Mm          , Ww          , Ww          , Ww          , Mm          , Mm          , Mm          , Mm          , Hh          , Mm          , Mm          , Mm          , Mm          , Mm          
Mm          , Mm          , Mm          , Mm          , Mm          , Mm          , Mm          , Mm          , Mm          , Mm          , Mm          , Mm          , Mm          , Gg          , Rd          , Gg          , Hh          , Hh          , Hh          , Mm          , Ww          , Ww          , Ww          , Mm^Vhh      , Mm          , Hh          , Mm          , Mm          , Mm          , Mm          , Mm          , Mm          
Mm          , Mm          , Mm          , Mm          , Mm          , Mm          , Mm          , Mm          , Mm          , Mm          , Mm          , Mm          , Mm          , Gg^Vc       , Rd          , Gg          , Gg          , Hh          , Hh          , Mm          , Ww          , Ww          , Ww          , Mm          , Hh          , Hh          , Hh^Vhh      , Mm          , Hh          , Mm          , Mm          , Mm          
Mm          , Mm          , Hh          , Mm          , Mm          , Mm          , Mm          , Mm          , Mm          , Mm          , Mm          , Mm          , Hh          , Hh          , Hh          , Rd          , Rd          , Gg          , Gg          , Hh          , Ww          , Ww          , Ww          , Hh          , Gg          , Gs^Fp       , Gs^Fp       , Mm          , Hh          , Gs^Fp       , Gs^Fp       , Gs^Fp       
Mm          , Mm          , Hh          , Mm          , Gg^Vc       , Mm          , Mm          , Mm          , Mm          , Mm          , Mm          , Mm          , Mm          , Mm          , Mm          , Hh          , Hh          , Rd          , Rd          , Gs^Fp       , Ww          , Ww          , Ww          , Hh          , Gs^Fp       , Gs^Fms      , Gs^Fp       , Mm          , Gg          , Gs^Fms      , Gs^Fms      , Gs^Fp       
Mm          , Mm          , Mm          , Mm          , Mm          , Mm          , Mm          , Mm          , Mm          , Mm          , Mm          , Mm          , Mm          , Mm          , Mm          , Mm          , Hh          , Gs^Fp       , Gs^Fp       , Rd          , Ww          , Ww          , Ww          , Ww          , Gg          , Gs^Fms      , Gs^Fp       , Mm          , Gg^Efm         , Gs^Fms      , Hh          , Hh          
Hh          , Hh          , Mm          , Mm          , Mm          , Mm          , Mm          , Mm          , Mm          , Mm          , Mm          , Mm          , Mm          , Mm          , Hh          , Mm          , Hh          , Hh          , Gs^Fp       , Ww          , Ww          , Ww          , Ww          , Gg          , Gs^Fms      , Gg          , Gg          , Mm          , Mm          , Gg          , Hh          , Hh          
Mm          , Mm          , Mm          , Mm          , Mm          , Mm          , Mm          , Mm          , Gg^Vc       , Mm          , Mm          , Mm          , Hh          , Hh          , Hh          , Hh          , Gg          , Gg          , Gg          , Ww          , Ww          , Ww          , Ww          , Gg^Efm         , Gs^Fms      , Gs^Fp       , Gs^Fms      , Gg          , Ww^Bw\      , Gg          , Gs^Fp       , Gs^Fp       
Mm          , Mm          , Mm          , Mm          , Mm          , Mm          , Mm          , Mm          , Mm          , Mm          , Mm          , Mm          , Mm          , Gs^Fp       , Gs^Fp       , Gs^Fp       , Gs^Fp       , Gs^Fms      , Gs^Fds      , Ww          , Ww          , Ww          , Gg          , Gs^Fds      , Gs^Fms      , Gs^Fp       , Hh^Fms      , Hh^Fms      , Mm          , Hh          , Gg          , Gg          
Mm          , Mm          , Mm          , Mm          , Mm          , Mm          , Mm          , Mm          , Mm          , Mm          , Mm          , Mm          , Mm          , Gs^Fp       , Gs^Fds      , Gs^Fms      , Gs^Fms      , Gs^Fms      , Gs^Fds      , Ww          , Ww          , Ww          , Gg          , Gs^Fms      , Gs^Fms      , Gs^Fms      , Hh^Fms      , Hh^Fms      , Mm          , Mm          , Gg          , Gg          
