border_size=1
usage=map

Hh^Fp       , Hh^Fp       , Hh          , Hh^Fp       , Gs^Fms      , Gs^Fms      , Gs^Fms      , Gs^Fms      , Gs^Fms      , Gs^Fms      , Gs^Fms      , Gs^Fms      , Gs^Fms      , Gs^Fms      , Gs^Fms      , Rd          , Gg          , Gs^Fds      , Gs^Fds      , Gs^Fms      , Gs^Fms      , Gs^Fms      , Gs^Fms      , Gs^Fms      , Gs^Fms      , Gs^Fms      , Gs^Fms      , Gs^Fms      , Gs^Fms      , Gs^Fms      , Gs^Fms      , Gs^Fms      
Hh^Fp       , Hh^Fp       , Gs^Fp       , Hh^Fms      , Gs^Fms      , Gs^Fms      , Gs^Fp       , Gs^Fp       , Gs^Fms      , Gs^Fms      , Gs^Fms      , Gs^Fp       , Gs^Fp       , Gs^Fds      , Gs^Fms      , Rd          , Rd          , Gs^Fms      , Gs^Fds      , Gs^Fms      , Gs^Fms      , Gs^Fms      , Gs^Fms      , Gg^Ve       , Gs          , Gs^Fms      , Gs^Fp       , Gs^Fp       , Gs^Fms      , Gs^Fms      , Gs^Fp       , Gs^Fms      
Hh^Fp       , Hh          , Hh          , Gs^Fp       , Gs^Fms      , Gs^Fms      , Gs^Fp       , Gs^Fds      , Gs^Fms      , Hh^Fds      , Hh^Fms      , Gs^Fms      , Gs^Fms      , Gs^Fp       , Gs^Fp       , Gs          , Rd          , Gs^Fds      , Gs^Fms      , Gs^Fms      , Gs^Fms      , Gs^Fms      , Gs^Fms      , Gs^Fms      , Gs^Fms      , Re^Gvs      , Re^Gvs      , Gg^Efm         , Gg^Fet      , Gs^Fms      , Gs^Fms      , Gs^Fms      
Hh^Fp       , Hh          , Hh^Fp       , Gs^Fms      , Gs^Fms      , Gs^Fp       , Gs^Fms      , Gs^Fms      , Gs^Fms      , Hh          , Hh^Fp       , Hh^Fds      , Gs^Fms      , Gs^Fms      , Gs^Fp       , Rd          , Gg          , Gs^Fms      , Gs^Fms      , Gs^Fp       , Gs^Fp       , Gs^Fds      , Gs^Fms      , Gs^Fds      , Gs^Fms      , Re^Gvs      , Re^Gvs      , Re^Gvs      , Gg^Efm         , Gs^Fms      , Gs^Fms      , Gs^Fms      
Hh^Fp       , Hh          , Gs^Fms      , Gs^Fms      , Gs^Fp       , Gs^Fms      , Re          , Re          , Re          , Hh^Fp       , Hh^Fp       , Hh^Fms      , Gs^Fms      , Gs^Fms      , Rd          , Rd          , Gs          , Gs^Fms      , Gs^Fms      , Gs^Fms      , Gs^Fms      , Gs^Tf       , Gs^Fms      , Gs^Fms      , Gs^Fp       , Gs^Fp       , Gs^Fms      , Re^Gvs      , Gs          , Gs^Fds      , Gs^Fms      , Gs^Fms      
Gs^Fp       , Hh^Fms      , Gs^Fms      , Gs^Fds      , Gs^Fp       , Gs^Fms      , Gs^Fms      , Gs^Fdw      , Gs^Fms      , Gs          , Rd          , Rd          , Rd          , Rd          , Gg          , Gs^Fms      , Gs^Fms      , Gs^Fms      , Gs^Fms      , Gs^Fds      , Gs^Fms      , Gs^Fms      , Gs^Fms      , Gs^Fp       , Gs^Fms      , Gs^Fms      , Gg^Ve       , Gs          , Gs          , Gs^Fms      , Gs^Fms      , Gs^Fms      
Gs^Fp       , Gs^Fp       , Gs^Fds      , Gs^Fms      , Gs^Fp       , Gs^Fp       , Gs^Fms      , Gs^Fms      , Gs          , Gs          , Rd          , Gs^Fms      , Gs^Fms      , Gs^Fms      , Gs^Fms      , Gs^Fms      , Gs^Fms      , Gs^Fds      , Gs^Fp       , Gs^Fms      , Gs^Fms      , Gs^Fms      , Gs^Fms      , Gs^Fds      , Gs^Fms      , Gs^Fms      , Gs^Fms      , Gg          , Gg^Ve       , Gs^Fms      , Gs^Fds      , Gs^Fms      
Gs^Fp       , Gs^Fms      , Gs^Fms      , Gs^Fms      , Gs^Fms      , Gs^Fds      , Gs^Fms      , Gs^Fms      , Rd          , Rd          , Gs^Fds      , Gs^Fms      , Gg^Fet      , Gs^Fms      , Gs^Fp       , Gs^Fds      , Ss          , Gs^Fms      , Gs^Fms      , Gs^Fp       , Gs^Fms      , Gs^Fds      , Gs^Fms      , Gs^Fms      , Gs^Fms      , Ss          , Gs^Fms      , Gs^Fms      , Gs^Fms      , Gs^Fms      , Gs^Fms      , Gs^Fms      
Gs^Fms      , Gs^Fms      , Gs^Fms      , Gs^Fp       , Gs^Fp       , Gs^Fms      , Rd          , Rd          , Rd          , Gs^Fms      , Gs^Fms      , Gs^Fms      , Gs^Fms      , Gs^Fms      , Gs^Fms      , Gs^Fms      , Gs^Fms      , Gs^Fms      , Gs^Fms      , Gs^Fp       , Gs^Fms      , Gs^Fms      , Gs^Fms      , Re          , Gs^Fms      , Gs^Fms      , Gs^Fds      , Gs^Fms      , Gs^Fds      , Gs^Fms      , Gs^Fms      , Gs^Fms      
Gs^Fp       , Gs^Fms      , Gs^Fms      , Gs^Fds      , Gs^Fms      , Gs^Fms      , Rp          , Gs^Fms      , Gs^Fms      , Rd          , Gs          , Gg          , Gg          , Gg          , Gg          , Ds          , Gs          , Ss^Vhs      , Gs^Fms      , Gs^Fms      , Gs^Fds      , Gs^Fms      , Re          , Re          , Gs^Fms      , Gs^Fms      , Gs^Fms      , Gs^Fms      , Gs^Fms      , Gs^Fms      , Gs^Fms      , Gs^Fms      
Gs^Fms      , Gs^Fms      , Gs^Fds      , Gs^Fms      , Gs^Fms      , Gg^Ve       , Rp          , Gg          , Gs          , Rd          , Rp          , Gg^Efm         , Gs          , Gg          , Re^Gvs      , Gg          , Gg          , Gs          , Gs^Fms      , Gs^Fms      , Gs^Fms      , Gs^Fms      , Gs^Fms      , Gs^Fms      , Gs^Fp       , Gs^Fp       , Gs^Fms      , Gs^Fms      , Gs^Fms      , Gs^Fds      , Gs^Fds      , Gs^Fms      
Gs^Fms      , Gs^Fms      , Gs^Fms      , Gs^Fms      , Gs^Fp       , Gs^Fms      , Rp          , Gg          , Gg^Efm         , Rp          , Gg^Ve       , Rp          , Gs          , Gg          , Re^Gvs      , Re^Gvs      , Gg          , Gg          , Gs          , Gs^Fms      , Gs^Fms      , Gs^Fms      , Gs^Fds      , Gs^Fms      , Gs^Fms      , Gs^Fms      , Ww          , Ss          , Gs^Fms      , Gg          , Gs^Fds      , Gs^Fms      
Gs^Fms      , Gs^Fp       , Gs^Fms      , Gs^Fms      , Gs^Fms      , Gs^Fms      , Rp          , Rp          , Rp          , Rp          , Rp          , Rp          , Gs          , Gg^Efm         , Gg          , Re^Gvs      , Gg          , Gs^Fms      , Gs^Fms      , Gs^Fms      , Gs^Fms      , Gs^Fds      , Gs^Fms      , Gs^Fms      , Gg^Efm         , Ds          , Gs^Fms      , Gs^Fms      , Gs^Fms      , Gs^Fms      , Gs^Fms      , Gs^Fms      
Gs^Fms      , Gs^Fms      , Gs^Fms      , Gg^Ve       , Gs          , Rp          , Gs          , Gg          , Gg          , Gs          , Rd          , Gs          , Gg          , Gg          , Gg          , Gg          , Gg^Efm         , Gs^Fms      , Gs^Fms      , Gs^Fp       , Gs^Fms      , Gs^Fms      , Gs^Fms      , Gs^Fms      , Cv          , Cv          , Cv          , Cv          , Gs^Fms      , Gs^Fms      , Gs^Fms      , Gs^Fms      
Gs^Fms      , Gs^Fms      , Gs^Fms      , Gs^Fms      , Cv          , Cv          , Cv          , Gs^Fms      , Gs^Fms      , Gs^Fms      , Rd          , Gg          , Gg          , Gs^Fms      , Gs^Fms      , Gs^Fms      , Gg          , Gg          , Gs          , Gs          , Gs^Fms      , Gs^Fds      , Gs^Fms      , Gs^Fms      , Cv          , 3 Kv        , Cv          , Gs^Fms      , Gs^Fms      , Gs^Fds      , Gs^Fms      , Gs^Fms      
Gs^Fms      , Gs^Fms      , Gs^Fms      , Cv          , Gs^Fds      , 2 Kv        , Gs^Fds      , Cv          , Gs^Fms      , Gg^Fet      , Gs^Fms      , Rd          , Gg          , Gs^Fds      , Gs^Fms      , Gs^Fms      , Gs^Fms      , Gs^Fms      , Gs^Fms      , Gs^Fms      , Gs^Fms      , Gs^Fms      , Gs^Fms      , Cv          , Gs^Fms      , Cv          , Gs^Fms      , Gs^Fms      , Gs^Fms      , Gs^Fds      , Gs^Fms      , Gs^Fms      
Gs^Fms      , Gs^Fms      , Gg^Ve       , Gs^Fds      , Cv          , Cv          , Cv          , Gs^Fds      , Gs^Fp       , Gs^Fms      , Gs^Fds      , Rd          , Gg          , Gs^Fms      , Gs^Fms      , Gs^Fds      , Gs^Fp       , Gs^Fms      , Gs^Fds      , Gs^Fms      , Gs^Fms      , Gs^Fds      , Gs^Fms      , Gs^Fms      , Gs^Fms      , Gs^Fms      , Gs^Fms      , Gs^Fms      , Gs^Fp       , Gs^Fms      , Gs^Fms      , Gs^Fms      
Gs^Fds      , Gs^Fds      , Gs^Fds      , Rp          , Gs^Fms      , Gs^Fms      , Gs^Fp       , Gs^Fms      , Gs^Fp       , Gs^Fds      , Rd          , Rd          , Gg          , Gs          , Gs^Fms      , Gs^Fms      , Gs^Fms      , Gs^Fp       , Gs^Fms      , Gs^Fms      , Gs^Fp       , Gs^Fp       , Gs^Fp       , Gs^Fms      , Gs^Fds      , Gs^Fms      , Gs^Fms      , Gs^Fp       , Gs          , Gs^Fp       , Gs^Fms      , Gs^Fms      
Ww          , Ww          , Ww          , Rd          , Gs^Fds      , Gs^Fms      , Gs^Fms      , Gs^Fp       , Gs^Fms      , Gs^Fms      , Rd          , Gg          , Gg^Efm         , Gs^Fms      , Gs^Fds      , Gg^Ve       , Gs^Fms      , Gs^Fms      , Gs^Fms      , Gs^Fms      , Gs^Fms      , Gs^Fms      , Gs^Fms      , Gs^Fms      , Gs^Fms      , Gs^Fms      , Gs^Fms      , Gs^Fp       , Gs^Fp       , Gs^Fp       , Gs^Fms      , Gs^Fms      
Gs^Fds      , Gs^Fds      , Gs^Fds      , Ww^Bw|      , Wwf         , Gs^Fds      , Hh^Fds      , Gs^Fds      , Gs^Fds      , Gs^Fms      , Rd          , Gg          , Hh^Fds      , Gs^Fms      , Wwf         , Gs^Fms      , Gs^Fds      , Gs          , Gs          , Gg          , Gs          , Gs^Fds      , Gs^Fds      , Gs^Fds      , Gs^Fds      , Gs^Fms      , Gs^Fms      , Gs^Fms      , Gs^Fms      , Gs^Fms      , Rd          , Gs^Fms      
Gs^Fms      , Gs^Fms      , Gs^Fms      , Rd          , Rd          , Wwf         , Wwf         , Wwf         , Wwf         , Gs^Fds      , Wwf^Bw|     , Gs^Fds      , Wwf         , Wwf         , Gs^Fds      , Wwf         , Ww          , Ww          , Ww          , Gs^Fds      , Ss          , Ss          , Ss          , Ss          , Wwf         , Gs^Fds      , Wwf         , Gs^Fds      , Rd          , Rd          , Gs^Fds      , Rd          
Gs^Fms      , Gs^Fms      , Gs^Fms      , Gs^Fms      , Rd          , Gs^Fds      , Gs^Fds      , Gs^Fds      , Gs^Fds      , Wwf         , Gs^Fds      , Wwf         , Gs^Fds      , Gs^Fms      , Gs^Fms      , Gs^Fds      , Ww          , Ww          , Ww          , Ww          , Wwf         , Wwf         , Wwf         , Wwf         , Hh          , Wwf         , Rd          , Ww^Bw/      , Wwf         , Gs^Fds      , Wwf         , Gs^Fds      
Gs^Fms      , Gs^Fds      , Gs^Fms      , Gs^Fms      , Rd          , Gs^Fms      , Gs^Fms      , Gs^Fms      , Gs^Fms      , Gs^Fds      , Gs^Fms      , Gs^Fms      , Gs^Fms      , Gs^Fms      , Gs^Fms      , Gg^Fet      , Ww          , Wwr         , Ww          , Ww          , Re          , Ss          , Ss          , Ss          , Gs^Fds      , Gs^Fds      , Rd          , Gs^Fms      , Gs^Fds      , Wwf         , Gs^Fms      , Wwf         
Gs^Fms      , Gs^Fms      , Gs^Fms      , Gs^Fds      , Rd          , Gs^Fms      , Gs^Fp       , Gs^Fms      , Gs^Fms      , Gs^Fms      , Gs^Fds      , Gs^Fds      , Gs^Fms      , Gs^Fms      , Gs^Fms      , Ds          , Ww          , Ww          , Ww          , Gs^Fds      , Gs^Fms      , Gs^Fds      , Gs^Fds      , Hh          , Hh^Fp       , Gs^Fms      , Rd          , Gg^Fet      , Gs^Fms      , Gs^Fds      , Gs^Fms      , Gs^Fds      
Gs^Fp       , Gs^Fp       , Gs^Fms      , Rd          , Hh^Fms      , Gs^Fms      , Hh^Fp       , Hh^Fp       , Gs^Fms      , Gs^Fms      , Gs^Fms      , Gs^Fds      , Gs^Fms      , Gg^Efm         , Gs^Fms      , Gs^Fds      , Gs^Fds      , Gs^Fds      , Gs^Fds      , Gs^Fds      , Gs^Fms      , Gs^Fms      , Ww          , Gs^Fms      , Gs^Fp       , Gs^Fms      , Rd          , Gs^Fms      , Gs^Fms      , Gs^Fms      , Gs^Fms      , Gs^Fms      
Gs^Fms      , Gs^Fms      , Gs^Fms      , Rd          , Hh^Fms      , Hh^Fms      , Rd          , Gs^Fms      , Gg^Ve       , Gs^Fms      , Gs^Fms      , Gs^Fp       , Gs^Fp       , Gs^Fms      , Gs^Fms      , Gs^Fms      , Gs^Fms      , Gs^Fms      , Gs^Fms      , Gs^Fms      , Gs^Fms      , Gs^Fms      , Gs^Fms      , Gs^Fds      , Gs^Fms      , Gs^Fms      , Rp          , Gs^Fp       , Gs^Fms      , Gs^Fds      , Gs^Fms      , Gs^Fms      
Gs^Fms      , Gs^Fp       , Gs^Fms      , Rd          , Rd          , Rd          , Gs^Fms      , Rp          , Rp          , Gs^Fms      , Gs^Fms      , Gs^Fp       , Gs^Fms      , Gs^Fms      , Gg^Ve       , Gs^Fms      , Gs^Fms      , Gs^Fp       , Gs^Fms      , Gs^Fds      , Gs^Fp       , Gs          , Gs^Fms      , Gs^Fp       , Gs^Fms      , Gg^Ve       , Rp          , Gs^Fms      , Gs^Fds      , Gs^Fp       , Gs^Fp       , Gs^Fms      
Gs^Fms      , Gs^Fms      , Gs^Fms      , Gg^Fet      , Gs^Fms      , Gs^Fms      , Gs^Fms      , Gs^Fms      , Rd          , Gs^Fms      , Gs^Fms      , Gs^Fp       , Gs^Fms      , Gs^Fms      , Gs^Fms      , Rp          , Rd          , Gs^Fms      , Gs^Fms      , Gs^Fms      , Gs^Fp       , Gs^Fms      , Gs^Fms      , Gs^Fms      , Rd          , Rp          , Gs^Fms      , Gs^Fms      , Gs^Fms      , Gs^Fms      , Hh^Fds      , Gs^Fms      
Gs^Fms      , Gs^Fp       , Gs^Fms      , Gs^Fms      , Gs^Fp       , Gs^Fms      , Ce          , Ce          , Ce          , Rd          , Rd          , Rd          , Rd          , Rd          , Rd          , Rd          , Gs^Fms      , Rd          , Rd          , Gs^Fms      , Gs^Fms      , Gs^Fds      , Rd          , Rd          , Gs^Fms      , Gs^Fp       , Gs^Fms      , Gs^Fms      , Hh          , Gs^Fms      , Hh          , Hh^Fp       
Gs^Fms      , Gs^Fms      , Gs^Fds      , Gs          , Gs^Fms      , Gs^Fms      , Ce          , 1 Ke        , Ce          , Ce          , Gs^Fms      , Gs^Fms      , Gs^Fds      , Gs^Fms      , Gs^Fms      , Gs^Fms      , Gs^Fms      , Gs^Fms      , Gs^Fp       , Rd          , Rd          , Rd          , Gs^Fp       , Gs^Fms      , Gs^Fms      , Gs^Fms      , Hh^Fds      , Gs^Fms      , Hh          , Hh^Fp       , Hh          , Hh^Fp       
Gs^Fp       , Gs^Fp       , Gs^Fp       , Gs^Fms      , Gs^Fms      , Gs^Fms      , Ce          , Gs^Fms      , Ce          , Gs^Fms      , Gs^Fms      , Gs^Fds      , Gs^Fp       , Gs^Fms      , Gs^Fp       , Gs^Fms      , Gs^Fp       , Gs^Fms      , Gs^Fms      , Gs^Fms      , Gs^Fms      , Gs^Fms      , Gs^Fms      , Gs^Fp       , Hh^Fds      , Hh^Fp       , Hh          , Hh^Fp       , Hh          , Hh^Fp       , Hh^Fp       , Hh^Fp       
Gs^Fp       , Gs^Fp       , Gs^Fp       , Gs^Fms      , Gs^Fms      , Gs^Fms      , Gs^Fms      , Gs^Fms      , Gs^Fms      , Gs^Fms      , Gs^Fms      , Gs^Fms      , Gs^Fms      , Gs^Fp       , Gs^Fds      , Gs^Fp       , Gs^Fms      , Gs^Fds      , Gs^Fms      , Gs^Fms      , Gs^Fms      , Gs^Fms      , Gs^Fms      , Gs^Fms      , Gs^Fms      , Hh          , Gs^Fp       , Hh          , Gs^Fp       , Hh          , Hh^Fp       , Hh^Fp       
