border_size=1
usage=map

Hh^Fp       , Hh^Fp       , Hh^Fp       , Hh^Fp       , Gs^Fms      , Gs^Fms      , Gs^Fms      , Gs^Fms      , Ds          , Ww          , Ww          , Ww          , Ww          , Ww          , Ww          , Hd          , Hh          , Hh          , Gg          , Gg          , Gg          , Gg          , Gg          , Gg          , Gg          , Gg          , Gg          , Hh          , Hh          , Hh          , Hd          , Hd          , Hh          , Hh          , Hd          , Hd          , Mm          , Mm          , Mm          , Aa^Fpa      , Aa^Fpa      , Mm          , Mm          , Mm          , Mm          , Mm          
Hh^Fp       , Hh^Fp       , Gs^Fp       , Gs^Fms      , Gs^Fp       , Gs^Fms      , Gs^Fp       , Gs^Fp       , Ds          , Ww          , Ww          , Ww          , Ww          , Ww          , Ww          , Hd          , Gg          , Hh          , Gg          , Gg          , Gs          , Gg          , Gg          , Gg          , Hh          , Gg          , Hh          , Hh          , Hh          , Hd          , Mm          , Hd          , Hh^Fp       , Hd          , Mm          , Mm          , Mm          , Mm          , Mm          , Aa^Fpa      , Mm          , Mm          , Mm          , Mm          , Mm          , Mm          
Hh^Fp       , Hh^Fms      , Gs^Fp       , Re^Gvs      , Re^Gvs      , Gs^Fms      , Gs^Fds      , Gs^Fds      , Gs^Fms      , Ds          , Ww          , Ww          , Ww          , Ww          , Ww          , Gg          , Gg          , Gg          , Gg          , Gg          , Gg          , Gg          , Gg          , Hh          , Mm          , Hh          , Hd          , Hd          , Hh          , Mm          , Mm          , Mm          , Hh^Fp       , Gs^Fp       , Aa^Fpa      , Mm          , Mm          , Mm          , Mm          , Mm          , Mm          , Mm          , Mm          , Mm          , Mm          , Mm          
Hh^Fp       , Hh^Fp       , Gs^Fms      , Re^Gvs      , Gs^Fp       , Gg^Ve       , Gs^Fp       , Gs^Fp       , Gs^Fms      , Ds          , Ww          , Ww          , Ww          , Ww          , Ww          , Ww          , Gg          , Gg          , Gg^Efm         , Gg          , Re          , Re          , Hh          , Hh          , Mm          , Hh          , Hd          , Hh          , Hh^Fp       , Hd          , Hh^Fp       , Mm          , Gs^Fp       , Gs^Fp       , Hh^Fp       , Mm          , Aa^Fpa      , Ha^Vhha     , Mm          , Mm          , Mm          , Mm          , Mm          , Mm          , Mm          , Mm          
Hh^Fms      , Hh^Fms      , Gs^Fds      , Gs^Fms      , Gs^Fds      , Gs^Fms      , Gs          , Gs^Fms      , Ds          , Ds          , Ww          , Ww          , Ww          , Ww          , Ds          , Gg          , Gg          , Gg          , Gg          , Gg          , Re          , Gg^Vc       , Gs          , Hh          , Hh^Fp       , Hd          , Hh          , Hh          , Hh          , Gs^Fp       , Hd          , Gs^Fp       , Hh          , Hh^Fp       , Gs^Fp       , Hh^Fp       , Mm          , Aa^Fpa      , Mm          , Mm          , Ha^Vhha     , Mm          , Mm          , Mm          , Ha^Vhha     , Mm          
Gs^Fms      , Gs^Fms      , Gg^Efm         , Gs^Fms      , Gs^Fms      , Gs^Fp       , Gs^Fds      , Gs^Fds      , Ds          , Ww          , Ww          , Ww          , Ww          , Ww          , Ww          , Gg          , Gs          , Gs          , Gg          , Gg          , Gg          , Gs          , Gs          , Gs^Fp       , Gs          , Gg^Fet      , Gs          , Hh          , Gs          , Hd          , Hh          , Hh          , Hd          , Hh^Fp       , Hd          , Aa^Fpa      , Mm          , Mm          , Mm          , Mm          , Mm          , Mm          , Mm          , Mm          , Mm          , Mm          
Gs^Fms      , Gs^Fms      , Gs^Fms      , Gs^Fp       , Gs^Tf       , Gs^Fms      , Gs^Fms      , Gs^Fp       , Gs^Fms      , Ds          , Ww          , Ww          , Ww          , Ww          , Ww          , Gg          , Gs          , Gs          , Gg          , Gg          , Hh          , Gs          , Hh          , Gs          , Hd          , Gs          , Hh          , Gs          , Hd          , Mm          , Mm          , Hd          , Mm          , Hd          , Mm          , Hd          , Mm          , Mm          , Mm          , Mm          , Aa^Vea      , Mm          , Mm          , Mm          , Mm          , Mm          
Gs^Fms      , Gs^Fms      , Gs^Fp       , Gs^Fds      , Gs^Fp       , Gs^Fds      , Gs^Fms      , Gs^Fms      , Gg^Fet      , Ds          , Ww          , Ww          , Ww          , Ww          , Ww          , Gg          , Gg          , Gs          , Hh          , Gg^Efm         , Hh          , Hh          , Hd          , Hd          , Mm          , Mm          , Hh          , Hd          , Mm          , Mm          , Mm          , Mm          , Mm          , Mm          , Mm          , Mm          , Mm          , Mm          , Mm          , Mm          , Mm          , Mm          , Mm          , Mm          , Mm          , Mm          
Mm          , Gs^Fms      , Gs^Fp       , Gs^Fms      , Ss          , Gs^Fds      , Gs^Fms      , Gs^Fms      , Gs^Fms      , Ds          , Ww          , Ww          , Ww          , Ww          , Wwf         , Wwf         , Gg          , Hh          , Gg          , Hh          , Gs          , Hh          , Gs          , Hd          , Mm          , Hd          , Hh          , Hd          , Hd          , Mm          , Mm          , Mm          , Mm          , Mm          , Mm          , Mm          , Mm          , Mm          , Mm          , Mm          , Mm          , Mm          , Gs^Fmf      , Mm          , Aa^Vea      , Mm          
Mm          , Mm          , Mm          , Gs^Fms      , Gs^Fms      , Gs^Fms      , Ww          , Gs^Fms      , Ww          , Ds          , Ww          , Ww          , Wwf         , Wwr         , Wwf         , Wwr         , Wwf         , Gg          , Gg          , Gg          , Hh          , Gs          , Hh          , Hd          , Hd          , Hd          , Hh          , Hh          , Hd          , Hd          , Hd          , Mm          , Hd          , Mm          , Gs^Fp       , Mm          , Gs^Fp       , Mm          , Hh^Fp       , Mm          , Hh^Fmf      , Mm          , Gs^Fp       , Gs^Fp       , Gs^Fp       , Gs^Fp       
Mm          , Mm          , Mm          , Gs^Fms      , Ss          , Gs^Fms      , Gg^Efm         , Ww          , Ww^Bw\      , Ww          , Ww          , Ds          , Gg          , Wwf         , Wwf         , Wwf         , Wwf         , Gg          , Gg^Efm         , Gg          , Hh          , Hh          , Hh          , Hd          , Hh          , Hh          , Hh          , Hh          , Hh          , Hd          , Hh          , Hd          , Hh          , Hh^Fp       , Hd          , Hh^Fp       , Gs^Fp       , Gs^Fp       , Gs^Fp       , Gs^Fp       , Gs^Fp       , Gs^Fp       , Gs^Fp       , Gs^Fp       , Gs^Fp       , Gs^Fp       
Mm          , Mm          , Ss          , Gs^Fms      , Gs^Fds      , Gs^Fms      , Gs^Fms      , Ww          , Gs          , Ww          , Gg          , Gg^Efm         , Gg          , Wwr         , Wwf         , Wwr         , Ww          , Gg          , Gg          , Gg          , Gg          , Hh          , Gg          , Hh          , Gg          , Hh          , Gs          , Hh          , Gg          , Hh          , Gg          , Hh          , Gg          , Hh          , Gg          , Gs^Fp       , Gg          , Gs^Fp       , Gg          , Gs^Fp       , Gs^Fp       , Gs^Fp       , Gs^Fp       , Gs^Fp       , Gs^Fp       , Gs^Fp       
Gs^Fds      , Gs^Fds      , Gs^Fms      , Gs^Fp       , Gs^Fms      , Ss          , Gs^Fds      , Gs^Fms      , Gg^Efm         , Gs^Fms      , Gg          , Gg          , Gg^Efm         , Gg          , Gg          , Ww          , Ww          , Ww          , Ww          , Gg          , Gg          , Gg          , Gg          , Gg          , Gg          , Gg          , Gg          , Gg          , Gs^Fds      , Gg^Efm         , Gg          , Gg          , Gg          , Gg          , Gg          , Gg^Ve       , Gg          , Gg          , Gg          , Gg          , Rd          , Gs^Fms      , Rd          , Gs^Fms      , Gg^Ve       , Gs^Fp       
Gs^Fms      , Gs^Fms      , Gs^Fds      , Gs^Fms      , Gs^Fds      , Gs^Fms      , Gs^Fms      , Gs^Fms      , Rp          , Gs^Fms      , Gs          , Gg          , Gg          , Gg          , Gg          , Gg          , Ww          , Ww          , Ww          , Gg          , Gs^Fp       , Gs^Fds      , Gs^Fp       , Gg          , Gs^Fp       , Gg^Efm         , Gs^Fp       , Gs^Fds      , Gs^Fp       , Gs^Fds      , Gs^Fp       , Gs          , Gs^Fp       , Gg          , Gs^Fp       , Gg          , Gg          , Gg          , Rd          , Rd          , Gs^Fms      , Rd          , Gs^Fms      , Rd          , Rd          , Rd          
Gs^Fds      , Ss          , Gs^Fds      , Gs^Fms      , Gs^Fds      , Gs^Fms      , Gs^Fds      , Gs^Fds      , Gs^Fds      , Gg^Ve       , Gs          , Gs          , Gg          , Gg          , Gs^Fp       , Gs^Fds      , Gs^Fds      , Ww          , Ww          , Ww          , Ww          , Gs^Fp       , Gs^Fms      , Gs^Fms      , Gs^Fms      , Gs^Fms      , Gs^Fms      , Gs^Fms      , Gs^Fms      , Gs^Fms      , Gs^Fp       , Gs^Fms      , Gg^Ve       , Gs^Fms      , Gs^Fp       , Gs^Fms      , Rd          , Rd          , Gs^Vht      , Gs          , Gs^Fms      , Gg^Ve       , Gs^Fms      , Gs^Fms      , Gs^Fms      , Gs^Fms      
Gs^Fds      , Gs^Fms      , Gs^Fds      , Gs^Fds      , Gg^Ve       , Gs^Fds      , Gg          , Gs^Fms      , Gs          , Gs          , Gs          , Rd          , Rd          , Gs          , Gs^Fp       , Gs^Fds      , Gs^Fds      , Ww          , Ww          , Ww          , Ww          , Gs^Fms      , Gs^Fds      , Gs^Fms      , Gs^Fds      , Gs^Fms      , Gs^Vht      , Gs^Fms      , Gg^Fet      , Gs^Fms      , Gs^Fms      , Gs^Fms      , Re          , Gs^Fms      , Rd          , Rd          , Gs^Fms      , Gg          , Gs^Fms      , Gs^Fms      , Gs^Fms      , Gs^Fms      , Gs^Fms      , Gs^Fp       , Hh^Fp       , Gs^Fms      
Gs^Fds      , Gs^Fds      , Gs          , Re^Gvs      , Gs^Fds      , Gs          , Gs^Fms      , Gg          , Gs^Fds      , Gs^Fds      , Gg          , Gg          , Rd          , Gs          , Gs^Fds      , Gs^Fds      , Hh          , Gs^Fds      , Ww          , Ww          , Wo          , Ww          , Wwr         , Gs^Fms      , Gs^Fms      , Gs^Fms      , Gs^Fms      , Gs          , Gg^Efm         , Gs^Fms      , Gs^Fms      , Gs^Fds      , Gs^Fms      , Gs^Vht      , Rd          , Gg          , Gs^Fms      , Gg^Ve       , Gs^Fms      , Gs^Fp       , Gs^Fms      , Gs^Fds      , Gs^Fms      , Gs^Fms      , Gs^Fms      , Gs^Fms      
Gs^Fds      , Gs^Fms      , Gg^Ve       , Gg^Efm         , Gs^Fds      , Gs^Fms      , Gs^Fds      , Gs^Fds      , Hh^Fds      , Gs^Fds      , Gs^Fds      , Gg          , Gs^Fds      , Rd          , Gs^Fds      , Gs^Fms      , Gs^Fp       , Gs^Fds      , Ww          , Ww          , Wwr         , Wwr         , Wo          , Gs^Fds      , Ww          , Gs^Fms      , Gs^Fms      , Gg^Ve       , Gs^Fms      , Gg^Ve       , Gs^Fms      , Gs^Fms      , Gs          , Rd          , Gs^Fms      , Gs^Fds      , Gs^Fms      , Gg^Efm         , Gs^Fp       , Gs^Fms      , Gg^Ve       , Gs^Fms      , Gs^Fms      , Gg^Ve       , Gs^Fms      , Gs^Fms      
Gs^Fds      , Gs^Fds      , Gs^Fds      , Gs^Fds      , Gs^Fds      , Gs^Fds      , Gs^Fp       , Gs^Fp       , Gs^Fds      , Gs^Fms      , Gs^Fds      , Gs^Fds      , Gs^Fds      , Gs^Fds      , Gs^Fds      , Gs^Fds      , Gs^Fds      , Gs^Fds      , Gs^Fds      , Ww          , Gs^Fds      , Wo          , Wo          , Ww          , Wwr         , Gs^Fms      , Gs^Fms      , Gs^Fp       , Gs^Fp       , Gs^Fms      , Gs^Fms      , Gs^Fp       , Rd          , Rd          , Gs^Fms      , Gs^Fms      , Hh^Fms      , Gs^Fms      , Gs^Fds      , Gs^Fms      , Gs^Fms      , Gs          , Rd          , Gs          , Gs^Fp       , Gs^Fms      
Gs^Fds      , Gs^Fp       , Gs^Fds      , Gs^Fds      , Gs^Fp       , Gs^Fds      , Gs^Fds      , Hh^Fds      , Gs^Fds      , Gs^Fds      , Gs^Fds      , Gs^Fds      , Gs^Fms      , Rd          , Gs^Fds      , Gs^Fds      , Gs^Fds      , Gs^Fms      , Gs^Fds      , Gs^Fds      , Gs^Fds      , Ww          , Wwr         , Wwr         , Wo          , Gs^Fds      , Gs^Fms      , Gs^Fp       , Gs^Fms      , Gs^Fms      , Ww          , Rd          , Ww          , Gs^Fms      , Gs^Fms      , Gs^Fp       , Gs^Fp       , Ss          , Gs^Fms      , Gs^Fms      , Gs          , Rd          , Gg^Fet      , Rd          , Gs^Fds      , Gs^Fms      
Gs^Fds      , Gs^Fds      , Gs^Fms      , Gs^Fds      , Gs^Fds      , Gs^Fds      , Hh^Fds      , Hh^Fms      , Gs^Fds      , Gs^Fds      , Gg          , Gs^Fds      , Rd          , Rd          , Gs^Fds      , Gg^Ve       , Gs^Fds      , Gs^Fds      , Gs^Fds      , Gs^Fds      , Gs^Fds      , Ww          , Gs^Fds      , Wo          , Wo          , Ww          , Wwr         , Gs^Fms      , Ww          , Gs^Fds      , Ww          , Ww^Bw|      , Ww          , Gs^Fds      , Ww          , Gs^Fms      , Gs^Fms      , Hh^Fms      , Gs^Fms      , Gg^Ve       , Gs^Vht      , Rd          , Re^Gvs      , Re^Gvs      , Gs^Fms      , Gs^Fms      
Gs^Fds      , Gs^Fds      , Re^Gvs      , Gs^Fds      , Ss          , Gs^Fds      , Gs^Fds      , Gs^Fms      , Gs^Fms      , Gs^Fds      , Rd          , Rd          , Gs^Fds      , Gs^Fds      , Gs^Fds      , Gs^Fds      , Gs^Fdw      , Gs^Fms      , Gs^Fds      , Gs^Fms      , Gs^Fds      , Gs^Fds      , Gs^Fds      , Ww          , Wwr         , Wwr         , Wo          , Gs^Fds      , Ww          , Ww          , Cv          , Ww^Bw|      , Cv          , Ww          , Ww          , Gs^Fds      , Gs^Fds      , Gs^Fms      , Gs^Fp       , Gs^Fms      , Gs^Fms      , Gs^Fms      , Gs^Fp       , Gs^Tf       , Gs^Fp       , Gs^Fms      
Gs^Fds      , Re^Gvs      , Re^Gvs      , Gs^Fds      , Gs^Fds      , Ss          , Gs^Fds      , Gs^Fms      , Gs^Fms      , Gs^Fds      , Rd          , Gs^Fp       , Gs^Fds      , Gs^Fds      , Gs^Fms      , Gs^Fds      , Gs^Fds      , Gs^Fds      , Gs^Fds      , Gs^Fds      , Gs^Fds      , Gs^Fds      , Gs^Fds      , Ww          , Gs^Fds      , Wo          , Wo          , Ww          , Ww          , Ww          , Cv          , Rd          , Cv          , Ww          , Ww          , Ww          , Ww          , Gs^Fms      , Gs^Fms      , Gs^Fms      , Gs          , Gs^Fms      , Rd          , Gs          , Gs^Fms      , Gs^Fms      
Gs^Fds      , Gg^Ve       , Gs^Fds      , Gs^Fds      , Gs^Fds      , Gs^Fds      , Hh^Fp       , Gs^Fms      , Gs^Fds      , Gs^Fds      , Rd          , Gs^Fp       , Gs^Fms      , Gs^Fds      , Gs^Fds      , Gs^Fp       , Gs^Fp       , Gs^Fds      , Gs          , Gs          , Gs          , Gg^Ve       , Gs^Fds      , Gs^Fds      , Gs^Fds      , Ww          , Ww          , Wo          , Cv          , Cv          , Rp          , Gg^Efm         , Rp          , Cv          , Cv          , Ww          , Ww          , Gs^Fds      , Gs^Fms      , Gs^Fms      , Gs^Fms      , Gs^Fds      , Gs^Fms      , Gg^Ve       , Gs^Fms      , Gs^Fms      
Gs^Fds      , Gs^Fds      , Hh^Fms      , Gs^Fds      , Gs^Fms      , Gs^Fds      , Hh^Fms      , Hh^Fms      , Gs^Fds      , Gs^Fds      , Rd          , Gs^Fp       , Gs^Fds      , Gs^Fms      , Gs^Fds      , Gs^Fp       , Gs^Fds      , Gs^Fds      , Gs          , Gg^Fet      , Gs^Fms      , Re          , Gs^Fds      , Gs^Fds      , Ww          , Ww          , Ww          , Ww          , Cv          , Cv          , Gs^Fds      , Kv          , Gs^Fds      , Cv          , Cv          , Ww          , Ww          , Ww          , Ww          , Gs^Fms      , Ss          , Gs^Fp       , Gs^Fms      , Gg^Efm         , Gs^Fms      , Gs^Fms      
Hh^Fp       , Hd          , Mm          , Hd          , Hh^Fms      , Gs^Fds      , Gs^Fds      , Gs^Fds      , Gs^Fds      , Gg^Efm         , Gg          , Rd          , Gs^Fds      , Gs^Fds      , Gs^Fms      , Gs^Fds      , Gs^Fds      , Gg^Ve       , Gs^Fms      , Gs^Fms      , Ss          , Gs^Vht      , Gs^Fds      , Gs^Fds      , Ww          , Ww          , Ww          , Cv          , Cv          , Rd          , Gg^Fet      , Rp          , Gs          , Rd          , Cv          , Cv          , Ww          , Ww          , Ww          , Gs^Fms      , Gs^Fp       , Gs^Fms      , Gs^Fms      , Gs^Fds      , Gs^Fms      , Gs^Fms      
Hd          , Mm          , Mm          , Mm          , Hd          , Gs^Fds      , Gs^Fds      , Gs^Fds      , Gs^Fds      , Gs^Fds      , Gs^Fds      , Rd          , Gs^Fp       , Gs^Fds      , Gs^Fds      , Gs^Fds      , Gs^Fds      , Gg^Efm         , Gs^Fds      , Ss          , Ss          , Gs^Fds      , Gs^Fds      , Gs^Fds      , Gs^Fds      , Ww          , Ww          , Cv          , Cv          , Ce          , Rp          , Qxu         , Rp          , Kv          , Cv          , Cv          , Ww          , Ww          , Gs^Fms      , Gs^Fms      , Gs^Fms      , Gg^Ve       , Gs          , Gs^Fms      , Gs^Fp       , Gs^Fms      
Mm          , Mm          , Mm          , Mm          , Hh^Fms      , Gs^Fds      , Gs^Fds      , Gg^Ve       , Gs^Fds      , Gs^Fds      , Gg          , Rd          , Gs^Fds      , Gs^Fds      , Gs^Fds      , Gs^Fds      , Hh^Fp       , Gs^Fms      , Gs^Fds      , Gs^Fds      , Gs^Fds      , Gs^Fds      , Gs^Fms      , Gs^Fds      , Gs^Fds      , Ww          , Ww          , Cv          , Ww          , Rp          , Cv          , Ww          , Cv          , Rp          , Ww          , Cv          , Ww          , Ww          , Gs^Fds      , Hh^Fds      , Gs^Fp       , Gs^Fms      , Gs          , Gs^Fp       , Gs^Fms      , Gs^Fms      
Hd          , Mm          , Hh^Fms      , Hh^Fds      , Gs^Fds      , Gg^Ve       , Re          , Gs^Fp       , Gs^Fds      , Gs^Fds      , Gs          , Rd          , Gs^Fds      , Gs^Fds      , Gs^Fds      , Hh^Fms      , Re^Gvs      , Gs^Fds      , Gs^Fp       , Gs^Fms      , Gs^Fds      , Gs^Fds      , Gs^Fds      , Gs^Fds      , Gs^Fds      , Ww          , Wwf         , Ww          , Ww          , Cv          , Cv          , Rp          , Cv          , Cv          , Ww          , Ww          , Wo          , Ww          , Gs^Fds      , Gs^Fms      , Gs^Fms      , Gs^Fms      , Gs^Vht      , Gs          , Gg^Ve       , Gs^Fms      
Gs^Fds      , Hh^Fds      , Gs^Fds      , Hh^Fms      , Gs^Fds      , Gs^Fp       , Gs^Fp       , Gs^Fp       , Gs^Fds      , Gs^Fms      , Rd          , Rd          , Gs^Fds      , Gs^Fds      , Gs^Fds      , Hh^Fp       , Gg^Ve       , Gs^Fds      , Gs^Fp       , Gs^Fds      , Gs^Fds      , Gs^Fms      , Gs^Fds      , Gs^Fds      , Gs^Fds      , Gs^Fds      , Gs^Fds      , Ww          , Ww          , Cv          , Ww          , Rd          , Ww          , Cv          , Ww          , Wwr         , Wo          , Wwr         , Wwr         , Gs^Fms      , Ww          , Gs^Fms      , Gs^Fms      , Gs^Fms      , Gs^Fms      , Gs^Fms      
Gs^Fds      , Gs^Fds      , Ss          , Gs^Fds      , Gg^Ve       , Gs^Fp       , Gs^Fp       , Gs^Fp       , Gs^Fds      , Gs^Fds      , Rd          , Gg^Efm         , Gs^Fms      , Gs^Fds      , Gs^Fds      , Gs^Fds      , Gs^Fds      , Gs^Fds      , Gs^Fds      , Gs^Fds      , Gs^Fds      , Gs^Fds      , Gs^Fds      , Gs^Fds      , Hh          , Gs^Fds      , Gs^Fds      , Ww          , Gs^Fds      , Ww          , Ww          , Ww^Bw|      , Ww          , Ww          , Gs^Fms      , Wo          , Wwr         , Wwr         , Wo          , Gs^Fds      , Ww          , Gs^Fds      , Ww          , Gs^Fms      , Gs^Fms      , Gs^Fms      
Gs^Fms      , Gs^Fds      , Ss          , Gs^Fds      , Gs^Fds      , Gs^Fds      , Gs^Fds      , Gs^Fms      , Gs^Fds      , Gs^Fds      , Gs^Fds      , Rd          , Gs^Fds      , Gs^Fp       , Gs^Fms      , Gs^Fds      , Gs^Fms      , Gs^Fds      , Gs^Fds      , Gs          , Gs^Fds      , Gs^Fds      , Gs^Vht      , Gs^Fds      , Gs^Fds      , Gs^Fds      , Gs^Fp       , Gs^Fds      , Gs^Fds      , Ww          , Cv          , Ww^Bw|      , Cv          , Ww          , Gs^Fds      , Ww          , Gs^Fms      , Wo          , Wwr         , Wwr         , Wo          , Wwr         , Wo          , Gs^Fds      , Ww          , Gs^Fms      
Gs^Fms      , Gs^Fms      , Gs^Fds      , Wwf         , Wwf         , Gs^Fds      , Gs^Fds      , Gs^Fds      , Gs^Fds      , Gs^Fds      , Gg          , Rd          , Gs^Fms      , Gs^Fds      , Gs^Fp       , Gs^Fds      , Gs^Fds      , Hh          , Gs^Fds      , Gs^Fds      , Gs^Fds      , Gs^Fp       , Gs^Fds      , Gs^Fds      , Gs^Fms      , Gs^Fds      , Gs^Fds      , Gs^Fp       , Gs^Fds      , Gs^Fds      , Gs^Fds      , Ww^Bw|      , Gs^Fds      , Gs^Fds      , Gs^Fds      , Gs^Fds      , Wwf         , Ww          , Gs^Vht      , Wo          , Wwr         , Wo          , Wwr         , Wwr         , Wo          , Ww          
Gs^Fms      , Gs^Fms      , Gs^Fds      , Gs^Fds      , Gs^Fds      , Ss          , Ss^Tf       , Ss          , Ss          , Gs^Fds      , Gs^Fds      , Rd          , Gs^Fds      , Gs^Fds      , Gs^Fds      , Gs^Fp       , Gs^Fds      , Gs^Fds      , Gs^Fds      , Gs^Fds      , Ss          , Gs^Fds      , Gs^Fds      , Gs^Fms      , Gs^Fp       , Gs^Fds      , Gs^Fds      , Gs^Fds      , Gs^Fds      , Gs^Fds      , Gg          , Rd          , Gg          , Gs^Fds      , Gs^Fds      , Gs^Fds      , Wwf         , Gs^Fds      , Gs^Fds      , Ww          , Gs^Fds      , Ww          , Gs^Fms      , Wo          , Gg^Ve       , Wo          
Gs^Fms      , Gs^Fp       , Gs^Fp       , Gs^Fms      , Gs^Fds      , Ss          , Ss          , Gs^Fds      , Ss          , Ss          , Rd          , Rd          , Gs^Fds      , Gs^Fds      , Hh^Fds      , Gs^Fds      , Gs^Fds      , Gs^Fms      , Gs^Tf       , Gs^Fds      , Gs^Fds      , Gs^Fds      , Gs^Fds      , Gs^Fms      , Gs^Fms      , Gs^Fds      , Gs^Fds      , Gg^Ve       , Gs^Fds      , Gg          , Rd          , Rd          , Gg          , Gs^Fds      , Gs^Fds      , Wwf         , Hh^Fds      , Gs^Fds      , Gs^Fds      , Gs^Fds      , Gs^Fds      , Gs^Fds      , Gs^Fds      , Ww          , Gs^Fds      , Gg          
Hh^Fds      , Gs^Fds      , Gs^Fp       , Gs^Fds      , Gs^Fds      , Ss          , Gs^Fds      , Ss          , Rd          , Ss^Bw/      , Ss^Bw|      , Ss          , Ss          , Ss          , Hh^Fds      , Hh^Fds      , Gs^Fds      , Gs^Fds      , Gs^Fds      , Gs^Fds      , Gs^Vht      , Gs^Fds      , Gs^Fdw      , Gs^Fdw      , Gs^Fds      , Gs^Fds      , Gs^Fds      , Gs^Fds      , Rd          , Rd          , Gs^Fds      , Gg          , Gs^Fds      , Gg^Efm         , Gs^Fds      , Wwf         , Hh^Fms      , Gs^Fds      , Gs^Fp       , Hh^Fms      , Hh^Fds      , Gs^Fds      , Hh^Fds      , Gs^Fds      , Gs          , Gs          
Hh^Fds      , Hh^Fds      , Gs^Fds      , Gs^Fds      , Gs^Fds      , Gs^Fds      , Gs^Fds      , Rd          , Gs^Fds      , Ss          , Rd          , Ss          , Gs^Fds      , Gs^Fds      , Gs^Fms      , Gs^Fds      , Gs^Fds      , Gs^Fds      , Gs^Fds      , Gs^Fds      , Gs^Fds      , Gs^Fds      , Gs^Fds      , Gs^Fdw      , Gs^Fds      , Gs^Fds      , Rd          , Gs^Vht      , Rd          , Gg          , Gs^Fds      , Gs^Vht      , Gs^Fds      , Gs^Fds      , Hh^Fds      , Wwf         , Gs^Fds      , Gs^Fds      , Gs^Fds      , Hh^Fds      , Gs^Fp       , Hh^Fms      , Hh^Fds      , Gs          , Gs^Fms      , Gs^Fms      
Hh^Fds      , Hh^Fds      , Gs^Fds      , Re^Gvs      , Re^Gvs      , Re^Gvs      , Gg^Efm         , Gg^Ve       , Gs^Fds      , Gs^Fds      , Rd          , Gs          , Gs^Fds      , Gs^Fds      , Gs^Fdw      , Gs^Fds      , Gs^Fms      , Gs^Fds      , Gs^Fds      , Gs^Fms      , Gs^Fds      , Gs^Fds      , Gs^Fds      , Gs^Fds      , Rd          , Rd          , Gs^Fds      , Rd          , Gs^Fds      , Gs^Fds      , Gs^Fds      , Gs^Fds      , Wwf         , Hh^Fds      , Wwf         , Wwf         , Hh^Fms      , Gs^Vht      , Gs^Fds      , Gs^Fds      , Gs^Fds      , Gs^Fds      , Gs^Fds      , Gs          , Gs^Fds      , Gs^Fms      
Gs^Fds      , Gs^Fds      , Gs^Fds      , Re^Gvs      , Gs^Fds      , Re^Gvs      , Gs^Fds      , Gs^Fds      , Gs^Fds      , Gs^Fds      , Gg^Efm         , Rd          , Gs^Fds      , Gs^Fdw      , Gs^Fms      , Gs^Fds      , Gs^Fds      , Gs^Fds      , Rd          , Gs^Fms      , Rd          , Rd          , Rd          , Gs^Fds      , Rd          , Gs^Fds      , Gs^Fms      , Gs^Fds      , Hh^Fds      , Gs^Fds      , Wwf         , Wwf         , Hh^Fms      , Wwf         , Gs^Fds      , Gs^Fds      , Gs^Fds      , Gs^Fds      , Gs^Fp       , Gs^Fds      , Gs^Fp       , Gs^Fds      , Gs^Fds      , Gs          , Gs^Fds      , Gs^Fds      
Gs^Fds      , Gs^Fds      , Gs^Fds      , Gs^Fds      , Gs^Fds      , Gs^Fp       , Gs^Fds      , Gs^Fds      , Gs^Fp       , Gs^Fds      , Re          , Rd          , Gs          , Gs^Fds      , Gs^Fds      , Gs^Fds      , Gs^Fds      , Rd          , Gs^Fds      , Rd          , Gs^Fds      , Gg^Ve       , Gs^Fds      , Rd          , Gs^Fds      , Gs^Fds      , Gs^Fds      , Hh^Fds      , Mm          , Mm          , Wwf         , Hh^Fds      , Gs^Fms      , Gg^Ve       , Gs^Fds      , Gs^Fds      , Gs^Fds      , Gs          , Gs^Fds      , Gs^Fds      , Gs^Fds      , Re^Gvs      , Re^Gvs      , Gg^Ve       , Gs^Fds      , Gs^Fds      
Gs^Fds      , Gs^Fds      , Gs^Fds      , Gs^Fds      , Ss          , Gs^Fds      , Gs^Fds      , Gs^Fds      , Gs^Fds      , Gs^Fds      , Gs^Fds      , Gs^Fds      , Gs^Fds      , Gs          , Gg^Efm         , Gg^Ve       , Re          , Rd          , Gs^Fms      , Gs^Fms      , Gs^Fds      , Gs^Fds      , Gs^Fds      , Rd          , Gs^Fds      , Gs^Fds      , Gs^Fms      , Hh^Fds      , Wwf         , Wwf         , Gs^Fds      , Gs^Fds      , Gs^Fms      , Gs^Fms      , Gs^Fds      , Gs^Fds      , Gs^Fds      , Gs^Fds      , Gs^Fds      , Gs^Fds      , Gs^Fds      , Re^Gvs      , Gs^Fds      , Gs^Fds      , Gs^Fms      , Gs^Fms      
Gs^Fds      , Gs^Fds      , Gg^Fet      , Gs^Fds      , Gs^Fds      , Gs^Fds      , Gs^Fms      , Gs^Fds      , Gs^Fms      , Gs^Fds      , Gs^Fds      , Gs^Fds      , Gs^Fds      , Gg^Ve       , Gg^Efm         , Gs^Fds      , Gs^Fms      , Gs^Fp       , Gs^Fp       , Gs^Fp       , Gs^Fp       , Gs^Fds      , Gs^Fds      , Rd          , Rd          , Gs^Fds      , Gs^Fds      , Gs^Fds      , Wwf         , Gs^Fp       , Gs^Fds      , Gs^Fds      , Gs^Fds      , Gs^Fds      , Gs^Fds      , Gg^Fet      , Gs^Fds      , Gs^Fms      , Gs^Fp       , Gs^Fds      , Gs^Fds      , Gg^Ve       , Gs^Fds      , Gs^Fds      , Gs^Fms      , Gs^Fms      
Gs^Fds      , Gs^Fds      , Gs^Fds      , Gs^Fds      , Ss          , Gs^Fds      , Ss          , Gs^Fds      , Gs^Fds      , Gs^Fds      , Gs^Fds      , Gs^Fds      , Gg^Ve       , Gg^Efm         , Re          , Re          , Gs^Fp       , Gs^Fp       , Gs^Fp       , Gs^Fp       , Gs^Fp       , Gs^Fds      , Gs^Fds      , Mm          , Rd          , Gs^Fds      , Gs^Fds      , Gs^Fds      , Wwf         , Gs^Fds      , Gs^Fds      , Gs^Fds      , Gs^Fds      , Hh          , Gs^Fds      , Gs^Fds      , Gs^Fp       , Gs^Fp       , Gs^Fp       , Gs^Fp       , Gs^Fms      , Gs^Fds      , Gs^Fds      , Gs^Fds      , Gs^Fms      , Gs^Fms      
Gs^Fds      , Gs^Fds      , Gs^Fds      , Ss          , Ss          , Ss          , Gs^Fds      , Gs^Fds      , Gs^Fds      , Gs^Fds      , Gs^Fp       , Gs^Fds      , Gs^Fds      , Gs^Fds      , Gs^Fp       , Gs^Fp       , Gs^Fp       , Gs^Fp       , Gs^Fp       , Gs^Fp       , Gs^Fp       , Gs^Fds      , Gs^Fds      , Rd          , Gs^Fds      , Gs^Fds      , Gs^Fds      , Wwf         , Gs^Fds      , Ds          , Hd          , Ds          , Gs^Fds      , Gs^Fds      , Gs^Fds      , Gs^Fms      , Gs^Fp       , Gs^Fp       , Gs^Fp       , Gs^Fp       , Gs^Fms      , Gs^Fds      , Gs^Fds      , Gs^Fds      , Gs^Fms      , Gs^Fms      
Gs^Fds      , Gs^Fds      , Ss          , Ss          , Ss          , Ss          , Gs^Fds      , Gs^Fds      , Gs^Fds      , Gs^Fds      , Gs^Fds      , Gs^Fds      , Gs^Fds      , Gs^Fds      , Gs^Fms      , Gs^Fp       , Gs^Fp       , Gs^Fp       , Gs^Fp       , Gs^Fp       , Gs^Fp       , Gs^Fds      , Gg          , Rd          , Gg          , Gs^Fds      , Gs^Fds      , Wwf         , Ds          , Ds          , Gs^Fds      , Ds          , Gs^Fds      , Gs^Fds      , Gs^Fds      , Gs^Fms      , Gs^Fms      , Gs^Fp       , Gs^Fms      , Gs^Fp       , Gs^Fds      , Gs^Fds      , Gs^Fds      , Gs^Fms      , Gs^Fms      , Gs^Fms      
