border_size=1
usage=map

Gs^Fms      , Gs^Fms      , Gg          , Rp          , Gs^Fms      , Gs^Fms      , Gs^Fms      , Gs^Fms      , Gs^Fp       , Gs^Fms      , Hh^Fms      , Hh^Fms      , Hh^Fms      , Hh^Fp       , Hh^Fp       , Hh^Fms      , Hh^Fms      , Hh^Fms      , Hh^Fp       , Hh^Fms      , Gs^Fms      , Gs^Fms      , Gs^Fms      , Gs^Fms      , Gs^Fms      , Gs^Fms      , Gs^Fms      , Gs^Fms      , Gs^Fms      , Gs^Fds      , Ww          , Ww          
Gs^Fms      , Gs^Fms      , Gg          , Rp          , Gg^Ve       , Gs^Fms      , Gs^Fds      , Gs^Fms      , Gs^Fms      , Gs^Fms      , Gs^Fds      , Hh^Fms      , Hh^Fp       , Hh^Fms      , Hh^Fms      , Hh^Fp       , Hh^Fms      , Hh^Fp       , Hh^Fms      , Hh^Fms      , Gs^Fms      , Gs^Fms      , Gs^Fms      , Gg^Ve       , Gs^Fms      , Gs^Fms      , Gs^Fp       , Gs^Fms      , Gs^Fds      , Gs^Fds      , Ww          , Ww          
Gs^Fms      , Gs^Fms      , Gg^Ve       , Rp          , Rp          , Gs^Fms      , Gs^Fms      , Gs^Fp       , Gs^Fds      , Gs^Fds      , Gs^Fms      , Gs^Fms      , Gs^Fms      , Gs^Fms      , Gs^Fms      , Hh^Fms      , Gs^Fms      , Hh^Fms      , Gs^Fms      , Gs^Fms      , Gs^Fds      , Gs^Fds      , Gs^Fp       , Gs^Fms      , Gs^Fms      , Gs^Fp       , Gs^Fp       , Gs^Fms      , Gs^Fds      , Gs^Fds      , Ww          , Ww          
Gs^Fms      , Re^Gvs      , Re^Gvs      , Gs^Fms      , Gs^Fms      , Rp          , Rp          , Gs^Fms      , Gs^Fds      , Gs^Fp       , Gs^Fds      , Gs^Fds      , Gs^Fds      , Gs^Fms      , Gs^Fds      , Ss          , Gs^Tf       , Gs^Fms      , Gs^Fds      , Hh^Fp       , Hh^Fms      , Gs^Fms      , Gs^Fms      , Gs^Fp       , Gs^Fds      , Gs^Fms      , Gs^Fms      , Gs^Fms      , Gs^Fms      , Gs^Fds      , Ww          , Ww          
Gs^Fms      , Gs^Fms      , Gs^Fms      , Gs^Fms      , Gs^Fms      , Gs^Fms      , Rp          , Rp          , Rp          , Gs^Fms      , Gs^Fp       , Gs^Fms      , Gs^Fms      , Gs^Fms      , Gs^Fds      , Gs^Fms      , Gs^Fms      , Gs^Fms      , Gs^Fms      , Hh^Fp       , Gs^Fms      , Gs^Fms      , Gs^Fms      , Gs^Fds      , Gs^Fms      , Gs^Fp       , Re^Gvs      , Gs^Fms      , Gs^Fms      , Gs^Fds      , Ww          , Ww          
Gs^Fms      , Gs^Fms      , Gs^Fds      , Gs^Fp       , Gs^Fms      , Gs^Fms      , Gs^Fms      , Gs^Fms      , Gs^Fp       , Rp          , Rp          , Gs^Fms      , Gs^Fms      , Gs^Fms      , Gs^Fms      , Gs^Fms      , Gs^Fms      , Gs^Fp       , Gs^Fms      , Gs^Fms      , Gg^Fet      , Gs^Fms      , Gs^Fp       , Gs^Fms      , Gs^Fms      , Gs^Fms      , Gg^Ve       , Gs^Fms      , Gs^Fds      , Gs^Fds      , Ww          , Ww          
Gs^Fms      , Gs^Fms      , Gs^Fms      , Gs^Fms      , Gg^Efm         , Gs^Fms      , Gs^Fms      , Gs^Fms      , Gg^Ve       , Gs^Fms      , Rp          , Gs^Fms      , Gs^Fms      , Gs^Fds      , Gs^Fds      , Gs^Fds      , Gg^Efm         , Gs^Fp       , Ss          , Gs^Fp       , Gs^Fms      , Gs^Fms      , Gs^Fds      , Gs^Fds      , Gs^Fds      , Gs^Fds      , Gs^Fds      , Gg^Efm         , Gg^Ve       , Ww          , Ww          , Ww          
Gs^Fms      , Gs^Fms      , Gs^Fp       , Gs^Fms      , Gs^Fp       , Gs^Fms      , Gs^Fms      , Gs^Fms      , Rp          , Rp          , Gs^Fms      , Gs^Fms      , Gs^Fp       , Gs^Fp       , Gs^Fms      , Gs^Fms      , Gs^Fp       , Gs^Fms      , Gs^Fms      , Gs^Fds      , Gs^Fms      , Gs^Fds      , Gs^Fms      , Gs^Fms      , Gs^Fds      , Ww          , Ww          , Ww          , Ww          , Ww          , Ww          , Ww          
Gs^Fms      , Gs^Fp       , Gs^Fp       , Gs^Fms      , Gs^Fds      , Gs^Fds      , Rd          , Rd          , Rd          , Gs^Fms      , Gs^Fp       , Gs^Fms      , Gs^Fds      , Gs^Fms      , Gs^Fds      , Gs^Fms      , Gs^Fds      , Gs^Fms      , Gs^Fms      , Gs^Fms      , Gs^Fds      , Gs^Fms      , Gs^Fms      , Gs          , Ww^Bw/      , Ww          , Ww          , Ww          , Ww          , Ww          , Ww          , Ww          
Gs^Fms      , Gs^Fp       , Gs^Fms      , Gs^Fms      , Gs^Fms      , Gs^Fms      , Rd          , Gs^Fms      , Gs^Fms      , Rd          , Rd          , Gs^Fms      , Gs^Fds      , Gs^Fms      , Gs^Fds      , Gs^Fds      , Gs^Fms      , Ss^Vhs      , Gs^Fms      , Gs^Fms      , Rd          , Gs^Fds      , Rd          , Rd          , Gs^Fds      , Ww          , Ww          , Ww          , Ww          , Ww          , Ww          , Ww          
Gs^Fms      , Gs^Fms      , Gs^Fms      , Gs^Fms      , Gs^Fms      , Gg^Ve       , Rd          , Gs^Fms      , Gs^Fds      , Gs^Fms      , Rd          , Gs^Fms      , Gs^Fms      , Gs^Fms      , Gs^Fms      , Gs^Fms      , Gs^Fms      , Ss          , Gs^Fms      , Rd          , Gs^Fp       , Rd          , Gs^Fds      , Gs^Fms      , Gs^Fms      , Gs^Fds      , Ww          , Ww          , Ww          , Ww          , Ww          , Ww          
Gs^Fms      , Gs^Fms      , Gs^Fds      , Gs^Fds      , Gs^Fds      , Gs^Fms      , Rd          , Gs^Fms      , Gs^Fds      , Gs^Fds      , Gs^Fms      , Rd          , Rd          , Gs^Fds      , Rd          , Gs^Fms      , Gs^Fds      , Gs^Fms      , Rd          , Rd          , Gs^Fms      , Gs^Fds      , Gs^Fp       , Gs^Fms      , Gs^Fds      , Gs^Fds      , Ww          , Gs^Fds      , Gs^Fms      , Ds          , Gs^Fds      , Gs^Fds      
Gs^Fms      , Gs^Fms      , Gs^Fms      , Gs^Fms      , Gs^Fms      , Gs^Fp       , Rd          , Gs^Fms      , Gs^Fds      , Gs^Fds      , Gs^Fms      , Gs^Fms      , Gs^Fms      , Rd          , Gs^Fms      , Rd          , Rd          , Rd          , Gs^Fds      , Gs^Fp       , Gs^Fms      , Gs^Fms      , Gs^Fms      , Gs^Fms      , Gs^Fds      , Ww          , Ww          , Gs^Fds      , Gs^Fms      , Gs^Fms      , Gs^Fms      , Gs^Fms      
Gs^Fms      , Gs^Fms      , Gs^Fms      , Gg^Ve       , Rd          , Rd          , Gs^Fms      , Gs^Fms      , Gs^Fp       , Gs^Fds      , Hh^Fp       , Gs^Fms      , Gs^Fms      , Gs^Fp       , Gs^Fms      , Rd          , Cv          , Cv          , Cv          , Gs^Fms      , Gs^Fms      , Gs^Fp       , Gs^Fms      , Gs^Fds      , Ww          , Ww          , Gs^Fds      , Gs^Fds      , Gs^Fms      , Gs^Fds      , Gs^Fds      , Gs^Fds      
Gs^Fms      , Gs^Fms      , Gs^Fp       , Gs^Fms      , Cv          , Gs^Fds      , Cv          , Gs^Fp       , Gs^Fms      , Gs^Fms      , Hh^Fp       , Hh^Fp       , Hh^Fp       , Gs^Fds      , Gs^Fms      , Rd          , Cv          , Kv          , Cv          , Gs^Fms      , Gs^Fms      , Gs^Fp       , Gs^Fds      , Gs^Fms      , Gs^Fds      , Gs^Fds      , Gs^Fms      , Gs^Fms      , Gs^Fds      , Wwr         , Ww          , Ww          
Gs^Fms      , Gs^Fms      , Gs^Fms      , Cv          , Cv          , Kv          , Cv          , Cv          , Gs^Fds      , Gs^Fms      , Hh^Fp       , Hh^Fms      , Hh^Fp       , Gs^Fms      , Gs^Fms      , Cv          , Gg^Fet      , Cv          , Gg^Fet      , Cv          , Gs^Fms      , Gs^Fp       , Gs^Fms      , Gs^Fms      , Gs^Fms      , Gs^Fms      , Gs^Fms      , Gs^Fms      , Ww          , Wwr         , Ww          , Ww          
Gs^Fms      , Gs^Fms      , Gg^Ve       , Gs^Fms      , Cv          , Gs^Fds      , Cv          , Gs^Fms      , Gs^Fms      , Hh^Fp       , Hh^Fds      , Hh^Fp       , Gs^Fms      , Gs^Fds      , Gs^Fds      , Gs^Fp       , Cv          , Cv          , Cv          , Gs^Fp       , Gs^Fms      , Gs^Fds      , Gs^Fms      , Gs^Fds      , Hh^Fp       , Gs^Fms      , Gs^Fds      , Gs^Fms      , Gs^Fds      , Ww          , Ww          , Ww          
Gs^Fms      , Gs^Fms      , Gs^Fms      , Rd          , Gs^Fms      , Gs^Fp       , Gs^Fds      , Gs^Fms      , Gs^Fms      , Hh^Fp       , Gs^Fms      , Hh^Fp       , Hh^Fp       , Gs^Fds      , Gs^Fms      , Gs^Fms      , Gs^Fms      , Gs^Fds      , Gs^Fms      , Gs^Fms      , Gs^Fp       , Gs^Fms      , Hh^Fp       , Hh^Fds      , Wwf         , Gs^Fms      , Gs^Fms      , Gs^Fds      , Gg          , Ww          , Ww          , Ww          
Ww          , Ww          , Ww          , Rd          , Wwf         , Gs^Fms      , Ww          , Wwf         , Ww          , Gs^Fms      , Gs^Fms      , Hh^Fp       , Gs^Fms      , Gs^Fms      , Gs^Fms      , Gs^Fms      , Gg^Ve       , Gs^Fms      , Gs^Fms      , Gs^Fds      , Gs^Fms      , Gs^Fms      , Hh^Fp       , Hh^Fp       , Wwf         , Gs^Tf       , Gs^Fms      , Gs^Fds      , Gg          , Ww          , Ww          , Ww          
Gs^Fms      , Gs^Fp       , Gs^Fms      , Ww^Bw|      , Gs^Fms      , Wwf         , Gs^Fms      , Gs^Fds      , Gs^Fms      , Wwf         , Wwf         , Gs^Fms      , Gs^Fms      , Gs^Fds      , Gs^Fds      , Gs^Fds      , Gs^Fds      , Gs^Fms      , Gs^Fms      , Gs^Fms      , Gg^Efm         , Gs^Fds      , Gs^Fms      , Gs^Fms      , Gs^Fms      , Wwf         , Wwf         , Gs^Fms      , Gs^Fds      , Ww          , Ww          , Ww          
Gs^Fms      , Gs^Fms      , Gs^Fms      , Rd          , Rd          , Gs^Fds      , Gs^Fms      , Gs^Fds      , Gs^Fms      , Gs^Fds      , Wwf         , Gs^Fds      , Gs^Fms      , Gs^Fp       , Gs^Fms      , Gs^Fms      , Gs^Fds      , Gs^Fp       , Gs^Fds      , Gs^Fms      , Gs^Fms      , Gs^Fms      , Gs^Fds      , Gs^Fms      , Gs^Fms      , Gg          , Wwf         , Gs^Fms      , Gg          , Gs^Fds      , Ww          , Ww          
Gs^Fms      , Gs^Fms      , Gs^Fms      , Gs^Fms      , Re          , Gs^Fms      , Gs^Fds      , Gs^Fms      , Gs^Fds      , Gs^Fms      , Gs^Fms      , Wwf         , Wwf         , Wwf         , Wwf         , Gs^Fds      , Gs^Fms      , Gs^Fms      , Gs^Fms      , Gs^Fms      , Gs^Fms      , Hh^Fms      , Hh^Fds      , Gs^Fms      , Hh^Fp       , Gs^Fms      , Gg          , Ww^Bw/      , Wwf         , Gs^Fds      , Ww          , Ww          
Gs^Fp       , Gs^Fms      , Gs^Fms      , Gs^Fds      , Gs^Fds      , Gs^Fms      , Gs^Fms      , Gs^Fms      , Gs^Fms      , Gs^Fms      , Gs^Fms      , Gs^Fds      , Gs^Fms      , Gs^Fds      , Gs^Fms      , Wwf         , Gs^Fds      , Gs^Fms      , Gg^Fet      , Gs^Fms      , Gs^Fms      , Hh^Fp       , Ss          , Ss          , Hh^Fp       , Gs^Fms      , Gg          , Gs^Fms      , Gs^Fds      , Ss          , Ww          , Ww          
Gs^Fms      , Gs^Fms      , Gs^Fds      , Gs^Fms      , Gs^Fms      , Gs^Fms      , Gs^Fms      , Gs^Fp       , Gs^Fms      , Gs^Fp       , Gs^Fds      , Gs^Fms      , Gs^Fms      , Gs^Fms      , Gs^Fds      , Wwf         , Gs^Fms      , Gg^Ve       , Gs^Fms      , Gs^Fms      , Gs^Fds      , Gs^Fms      , Gs^Fms      , Hh^Fds      , Hh^Fp       , Gs^Fms      , Gs^Fms      , Gs^Fds      , Ww          , Ww          , Ww          , Ww          
Gs^Fp       , Gs^Fms      , Gs^Fds      , Gs^Fds      , Gs^Fms      , Gs^Fds      , Gs^Fms      , Gs^Fms      , Gs^Fms      , Gs          , Gs^Fms      , Gs^Fds      , Gs^Fp       , Gs^Fms      , Gs^Fds      , Wwf         , Wwf         , Wwf         , Wwf         , Wwf         , Wwf         , Gs^Fms      , Ww          , Gs^Fms      , Gs^Fds      , Gs^Fds      , Gg          , Gs^Fds      , Ww          , Ww          , Ww          , Ww          
Gs^Fp       , Gs^Fms      , Gs^Fds      , Gs^Fms      , Gs^Fds      , Gs^Fms      , Gs^Fms      , Gs^Fms      , Gg^Ve       , Gs^Fms      , Gs^Fms      , Gs^Fds      , Gs^Fms      , Gs^Fds      , Gs^Fms      , Gs^Fms      , Gs^Fms      , Gs^Fds      , Gs^Fms      , Gs^Fms      , Gg^Ve       , Ww          , Ww          , Ww          , Ww          , Ww          , Ww^Bw|      , Ww          , Gs^Fds      , Ww          , Gs^Fds      , Gs^Fds      
Gs^Fms      , Gs^Fms      , Gg^Efm         , Gs^Fms      , Gs^Fms      , Gs^Fds      , Gs^Fms      , Re          , Rd          , Gs^Fms      , Gs^Fms      , Gs^Fds      , Gs^Fds      , Gs^Fms      , Gg^Ve       , Gs^Fms      , Gs^Fms      , Gs^Fms      , Gs^Fms      , Gs^Tf       , Gs^Fms      , Gs^Fms      , Gs^Fms      , Gs^Fms      , Gs^Fms      , Gg^Ve       , Gs          , Gs^Fds      , Gs^Fds      , Gs^Fds      , Gs^Fds      , Gs^Fds      
Gs^Fp       , Gs^Fms      , Gs^Fms      , Gs^Fms      , Gs^Fds      , Gs^Fds      , Gs^Fms      , Gs^Fms      , Rp          , Gs^Fms      , Gs^Fds      , Gs^Fds      , Gs^Fms      , Gs^Fms      , Gs^Fms      , Gs^Fms      , Gs^Fms      , Gs^Fms      , Gs^Fms      , Gs^Fms      , Gs^Fds      , Gs^Fp       , Gs^Fms      , Gs^Fms      , Gs^Fp       , Gs^Fds      , Ww          , Ww          , Ww          , Ww          , Ww          , Ww          
Gs^Fms      , Gs^Fms      , Gs^Fp       , Gs^Fds      , Gs^Fds      , Gs^Fp       , Gs^Fp       , Gs^Fms      , Gs^Fms      , Rd          , Rd          , Gs^Fms      , Rd          , Rd          , Rp          , Rd          , Rd          , Rd          , Rd          , Gs^Fms      , Gs^Fms      , Gs^Fds      , Rd          , Re          , Gs^Fds      , Ww          , Ww          , Ww          , Ww          , Ww          , Ww          , Ww          
Gs^Fms      , Gs^Fp       , Gs^Fp       , Gs^Fds      , Gs^Fms      , Gs^Fms      , Gs^Fds      , Gs^Fms      , Gs^Fds      , Gs^Fds      , Rp          , Rp          , Gs^Fds      , Gs^Fds      , Gs^Fds      , Gs^Fds      , Gs^Fds      , Gs^Fds      , Gs^Fds      , Rd          , Re          , Rd          , Gs^Fds      , Gs^Fds      , Ww          , Ww          , Ww          , Ww          , Ww          , Ww          , Ww          , Ww          
Gs^Fms      , Gs^Fms      , Gs^Fms      , Gs^Fms      , Gs^Fms      , Gs^Fp       , Gs^Fms      , Gs^Fms      , Gs^Fds      , Ww          , Ww          , Ww          , Ww          , Ww          , Ww          , Wwr         , Ww          , Ww          , Ww          , Ww          , Ww          , Ww          , Ww          , Ww          , Ww          , Ww          , Ww          , Ww          , Ww          , Ww          , Ww          , Ww          
Gs^Fms      , Gs^Fms      , Gs^Fms      , Gs^Fms      , Gs^Fms      , Gs^Fms      , Gs^Fms      , Gs^Fds      , Gs^Fds      , Ww          , Ww          , Ww          , Ww          , Ww          , Ww          , Ww          , Ww          , Ww          , Ww          , Ww          , Ww          , Ww          , Ww          , Ww          , Ww          , Ww          , Ww          , Ww          , Ww          , Ww          , Ww          , Ww          
