border_size=1
usage=map

Mm          , Gg          , Mm^Xm       , Gg          , Mm^Xm       , Gg          , Mm^Xm       , Gg          , Mm^Xm       , Gg          , Mm^Xm       , Gg          , Gg          , Gg          , Gs^Fds      , Gs^Fds      , Gs^Fds      , Gs^Fds      , Gs^Fds      , Gs^Fds      , Gg          , Gg          , Ds          , Gg          , Ds          , Gg          , Ch          , Gg          , Hh          , Gg          
Mm          , Mm^Xm       , Mm          , Mm          , Mm          , Mm          , Mm          , Mm          , Mm          , Mm          , Mm^Vhh      , Mm          , Gg          , Gg          , Gs^Fds      , Gg^Vc       , Dd^Vda      , Gs^Fds      , Gs^Fds      , Gs^Fds      , Gg          , Gg          , Ds          , Gg          , Ds          , Ch          , Ch          , Ch          , Hh          , Mm          
Mm          , Hh          , Hh          , Hh^Fds      , Hh          , Gs^Fds      , Mm          , Mm          , Mm          , Mm          , Mm          , Mm          , Ss          , Gg          , Gs^Fds      , Gs^Fds      , Ds          , Gg          , Ds          , Gg          , Ds          , Gg          , Gg          , Gg          , Gg          , Ch          , 3 Kh        , Ch          , Mm          , Mm          
Gs^Fds      , Gs^Fds      , Gs^Fds      , Hh^Fds      , Hh^Fds      , Gs^Fds      , Hh^Vhh      , Gg          , Gg          , Gg          , Ss^Vhs      , Ss          , Gg          , Ss          , Gg          , Gg          , Ds          , Ds          , Ds          , Ds          , Gg          , Ds          , Ds          , Gg          , Gg          , Ch          , Ch          , Ch          , Hh          , Hh          
Gs^Fds      , Gs^Fds      , Gs^Fds      , Gs^Fds      , Gs^Fds      , Hh          , Hh^Fds      , Gs^Fds      , Gs^Fds      , Hh^Fds      , Hh          , Hh          , Gg          , Gg          , Gg          , Gg          , Gg          , Gg          , Gg          , Gg          , Gg          , Gg          , Gg          , Gg          , Gg          , Gg          , Hh          , Hh          , Hh          , Hh          
Gs^Fds      , Gs^Fds      , Gs^Fds      , Gs^Fds      , Gs^Fds      , Gs^Fds      , Gs^Fds      , Gg          , Gg          , Gg          , Gg          , Gg          , Gg          , Gg          , Gg          , Gg          , Gg          , Gg          , Gg          , Gg          , Gg          , Gg          , Gg          , Gg          , Gg          , Gg          , Hh          , Hh          , Hh          , Hh          
Gs^Fds      , Gs^Fds      , Gs^Fds      , Gs^Fds      , Gs^Fds      , Gs^Fds      , Gs^Fds      , Gs^Fds      , Gg          , Gg          , Gg          , Gg          , Gg          , Gg          , Gg          , Gg          , Gg          , Gg          , Gg          , Gg^Efm         , Gg          , Gg          , Gg          , Gg          , Gg          , Hh          , Hh          , Hh          , Hh          , Hh          
Gs^Fds      , Gs^Fds      , Gs^Fds      , Gs^Fds      , Gs^Fds      , Gs^Fds      , Gs^Fds      , Gg          , Gg^Efm         , Gg          , Gg          , Gg          , Gg          , Gg          , Gg          , Gg          , Gg          , Gg          , Gg          , Gg          , Gg          , Gg          , Gg          , Gg          , Gg          , Hh          , Hh          , Hh          , Hh          , Hh          
Gs^Fds      , Gs^Fds      , Gs^Fds      , Gs^Fds      , Gs^Fds      , Gs^Fds      , Gs^Fds      , Gg          , Gg          , Gg          , Gg          , Gg          , Gg          , Gg          , Gg          , Gg          , Gg          , Gg          , Gg          , Gg          , Gg          , Gg          , Gg          , Gg          , Gg          , Hh          , Hh          , Hh          , Hh          , Hh          
Gs^Fds      , Gs^Fds      , Gs^Fds      , Gs^Fds      , Gs^Fds      , Gg          , Gg          , Gg          , Gg          , Gg          , Gg          , Gg          , Gg          , Gg          , Dd^Vda      , Gg          , Gg          , Dd^Vda      , Ds          , Gg          , Dd^Vda      , Gg          , Ds          , Gg          , Gg^Efm         , Gg          , Gg          , Gg          , Hh          , Hh          
Gs^Fds      , Gs^Fds      , Gs^Fds      , Gs^Fds      , Gs^Fds      , Gs^Fds      , Gg          , Gg          , Gg          , Ss          , Gs^Fds      , Gs^Fds      , Gs^Fds      , Ds          , Ds          , Ds          , Ds          , Ds          , Ds          , Ds          , Ds          , Ds          , Ds          , Gg          , Gg          , Gg          , Gg          , Hh          , Hh          , Hh          
Gs^Fds      , Gs^Fds      , Gs^Fds      , Gs^Fds      , Gs^Fds      , Gs^Fds      , Ss          , Ss          , Gg          , Ss          , Ss          , Gs^Fds      , Gs^Fds      , Ds          , Dd^Vda      , Ds          , Ds          , Gg          , Ds          , Ds          , Ds          , Ds          , Gg          , Gg          , Gg          , Hh          , Hh          , Hh          , Hh          , Hh          
Gg          , Gs^Fds      , Gs^Fds      , Gs^Fds      , Gs^Fds      , Gs^Fds      , Gs^Fds      , Gs^Fds      , Gg          , Gg          , Ss          , Ss          , Gg          , Gg          , Gg          , Ds          , Gg          , Gg          , Gg          , Gg          , Gg          , Gg          , Gg          , Gg          , Hh          , Hh          , Hh          , Hh          , Hh          , Hh          
Gg          , Gg          , Gg          , Gg          , Gg          , Gg          , Ss          , Gg          , Gg          , Ss          , Ss^Vhs      , Ss          , Ss          , Ss          , Gg          , Gg          , Gs^Fds      , Gg^Vc       , Gg          , Gg          , Gg          , Gg          , Gg          , Hh          , Hh          , Hh          , Hh          , Hh          , Hh          , Mm          
Gg          , Gg          , Gg          , Gg          , Gg          , Gg          , Ss          , Ss          , Ss          , Ss          , Ss          , Gg          , Ss          , Ss          , Gg          , Gg          , Gs^Fds      , Gs^Fds      , Gs^Fds      , Gs^Fds      , Gs^Fds      , Gg          , Hh^Fds      , Hh          , Hh          , Hh          , Hh          , Hh          , Hh          , Mm          
Gg          , Gg          , Gg          , Gg          , Gg          , Gg          , Gg          , Ss          , Ss          , Ss          , Ww          , Ss          , Ww          , Gg          , Gg          , Gg          , Gg          , Gs^Fds      , Gs^Fds      , Gs^Fds      , Gg^Vc       , Gs^Fds      , Gs^Fds      , Gs^Fds      , Hh          , Hh          , Hh          , Hh          , Hh          , Mm          
Gg          , Gg          , Gg          , Gg          , Gg          , Gg          , Gg          , Gg          , Gg          , Gg          , Gg          , Gg          , Gg          , Gg          , Ss          , Ss          , Gs^Fds      , Gs^Fds      , Gs^Fds      , Gs^Fds      , Gg          , Gg          , Gg          , Gs^Fds      , Gs^Fds      , Gs^Fds      , Gs^Fds      , Hh          , Hh          , Mm          
Gs^Fds      , Gs^Fds      , Gs^Fds      , Gs^Fds      , Gs^Fds      , Ww          , Ww          , Gg          , Ss          , Gg          , Ss          , Gg^Vc       , Hh          , Hh          , Gg          , Gg          , Gg          , Gg          , Gg          , Gg          , Gg          , Gg          , Gg          , Gg          , Gg          , Gs^Fds      , Gs^Fds      , Hh          , Hh          , Mm          
Gs^Fds      , Gs^Fds      , Gs^Fds      , Gs^Fds      , Gs^Fds      , Gs^Fds      , Gg          , Gg          , Gg          , Gg          , Gg          , Ss          , Gg          , Gg          , Gg          , Ss          , Ss          , Gg          , Gg          , Gg          , Gg          , Gs^Fds      , Gs^Fds      , Hh^Fds      , Hh          , Hh          , Hh          , Hh          , Hh          , Mm          
Gs^Fds      , Gs^Fds      , Gs^Fds      , 1 Gs^Fds    , Gs^Fds      , Gs^Fds      , Gs^Fds      , Gs^Fds      , Gs^Fds      , Gs^Fds      , Gg          , Gg          , Gg          , Gg          , Gg          , Gg          , Ss          , Ss          , Gg          , Gg          , Gg          , Gg          , Gg          , Gg          , Hh          , Hh          , Hh          , Hh          , Hh          , Hh          
Gs^Fds      , Gs^Fds      , Gs^Fds      , Gs^Fds      , Gs^Fds      , Gs^Fds      , Gs^Fds      , Gs^Fds      , Gg          , Gg          , Ss          , Ss          , Ss          , Gg^Vc       , Ss          , Gg          , Gg          , Ss          , Dd^Vda      , Gg          , Gg          , Hh          , Hh          , Hh          , Hh          , Hh          , Hh          , Hh          , Hh          , Hh          
Gs^Fds      , Gs^Fds      , Gs^Fds      , Gs^Fds      , Gs^Fds      , Gs^Fds      , Gg          , Ss          , Gg          , Ss          , Gg          , Ss          , Ss          , Gg          , Gs^Fds      , Gg          , Ds          , Gg          , Ds          , Gg          , Hh          , Hh          , Hh          , Hh          , Hh          , Hh          , Hh          , Hh          , Hh          , Hh          
Gs^Fds      , Gs^Fds      , Gs^Fds      , Gs^Fds      , Gs^Fds      , Gs^Fds      , Ss          , Gg          , Gg          , Gg^Vc       , Gg          , Gg          , Gs^Fds      , Gs^Fds      , Gs^Fds      , Gg          , Ds          , Ds          , Ds          , Gg          , Ds          , Gg          , Gg          , Gg          , Gg          , Hh          , Hh          , Hh          , Hh          , Hh          
Gs^Fds      , Gs^Fds      , Gs^Fds      , Gs^Fds      , Gg          , Gg          , Gg^Vc       , Ss          , Gg          , Gg          , Gg          , Ds          , Ds          , Gs^Fds      , Gs          , Gs          , Ds          , Gs          , Ds          , Ds          , Gg          , Gg          , Gg          , Ds          , Gg          , Gg          , Gg          , Hh          , Hh          , Hh          
Gs^Fds      , Gs^Fds      , Gs^Fds      , Gs^Fds      , Gs^Fds      , Gs^Fds      , Gs^Fds      , Gs^Fds      , Gs^Fds      , Gs^Fds      , Ds          , Ds          , Ds          , Ds          , Ds          , Gs          , Gs          , Gs          , Dd^Vda      , Ds          , Ds          , Chs         , 2 Khs       , Chs         , Gg          , Gg^Efm         , Gg          , Hh          , Hh          , Hh          
Gg          , Gs^Fds      , Gs^Fds      , Gs^Fds      , Gs^Fds      , Gs^Fds      , Gs^Fds      , Gs^Fds      , Gs^Fds      , Ds          , Ds          , Ds          , Ds          , Dd^Vda      , Gs          , Gs          , Ds          , Ds          , Ds          , Gs          , Gs          , Ds          , Chs         , Ds          , Dd^Vda      , Gg          , Gg          , Hh          , Hh          , Hh          
Gg          , Gg          , Gg          , Gg          , Gg          , Gg          , Ss          , Ww          , Ss          , Gg          , Ds          , Gg          , Gg          , Gs          , Ds          , Ds          , Ds          , Ds          , Dd^Vdt      , Ds          , Ds          , Ww^Bw\      , Gg          , Gg          , Gg          , Gg          , Hh          , Hh          , Hh          , Hh          
Gg          , Gg          , Gg          , Gg          , Gg          , Gg          , Gg          , Gg          , Gg          , Gg          , Gg          , Gg          , Gg          , Dd^Vda      , Gs          , Ds          , Ds          , Ds          , Gg          , Gg          , Gg          , Gg          , Gg          , Gg          , Gg          , Hh          , Hh          , Hh          , Hh          , Hh          
Gg          , Gg          , Gg^Efm         , Gg          , Gg          , Gs^Fds      , Gs^Fds      , Gs^Fds      , Gg^Vc       , Gs^Fds      , Gs^Fds      , Gs^Fds      , Gs^Fds      , Dd^Vda      , Gs^Fds      , Gs^Fds      , Gs^Fds      , Gs^Fds      , Gs^Fds      , Gs^Fds      , Gg          , Gg          , Gg          , Gg          , Gg          , Hh          , Hh          , Gg^Vc       , Hh          , Hh          
Gg          , Gg          , Gg          , Gg          , Gg          , Gg          , Gs^Fds      , Gg^Vc       , Gs^Fds      , Gs^Fds      , Gg          , Gg          , Gg          , Gs^Fds      , Gg          , Gg          , Gg          , Ds          , Dd^Vda      , Ds          , Gs^Fds      , Gs^Fds      , Gg^Vc       , Gs^Fds      , Gs^Fds      , Gs^Fds      , Gs^Fds      , Ww          , Ww          , Wo          
Gg          , Gg          , Gg          , Gg          , Gg          , Gs^Fds      , Gs^Fds      , Gs^Fds      , Gs^Fds      , Gs^Fds      , Gs^Fds      , Gs^Fds      , Gs^Fds      , Gs^Fds      , Gs^Fds      , Gs^Fds      , Gs^Fds      , Gs^Fds      , Gs^Fds      , Gs^Fds      , Gs^Fds      , Gs^Fds      , Gs^Fds      , Gs^Fds      , Gs^Fds      , Gs^Fds      , Gs^Fds      , Gs^Fds      , Ww          , Wo          
Gg          , Gg          , Gg          , Gg          , Gg          , Gs^Fds      , Gs^Fds      , Gs^Fds      , Gs^Fds      , Gs^Fds      , Gs^Fds      , Gs^Fds      , Gs^Fds      , Gs^Fds      , Gs^Fds      , Gs^Fds      , Gs^Fds      , Gs^Fds      , Gs^Fds      , Gs^Fds      , Gs^Fds      , Gs^Fds      , Gs^Fds      , Gs^Fds      , Gs^Fds      , Gs^Fds      , Gs^Fds      , Gs^Fds      , Ww          , Wo          
